#############################
#.................#.........#
#@................#.........#
##############....#.........#
#...#.....#.......#.........#
#...#.....#.......#.........#
#...#.....#.......#.........#
#...#..... .......#.........#
#...#.........#####.........#
#...#...#.....#.............#
#...#...#.....#.............#
#...#...#############.......#
#...#...#...................#
#...#...#...mn_.............#
#...#...#...................#
#...#...#...#....#..........#
#...#...#...#....#..........#
#...#...#...#....#..........#
#.......#...#....#..........#
#.......#...#....#..........#
#...#########....#..........#
#................#..........#
#................#..........#
########.........#..........#
#................#..........#
#############################
