############################
#..........................#
#..########...........m....#
#..#......#................#
#..#......#................#
#..#......#..########......#
#..#......#..#......#......#
#..#......#..#......#......#
#..#......#..#......#......#
#..#......#..#......#......#
#..#......#..#......#......#
#..#......#..#......#......#
#..#......#..#......#......#
#..#......#..#......#......#
#..#......#..#......####...#
#.g#......#..#..@..........#
#..#......#..#.............#
#..#......#..#.............#
#..#......#..#.............#
#..#......#..###############
#..#......#................#
#..#......#................#
#..#......#................#
#..#......#................#
#..#......#......._........#
#..#......#................#
#..########................#
#..........................#
#..........................#
############################
