##################
#................#
#....@...........#
#................#
######.....#######
#....#.....#._...#
#....#.....#.....#
#....#.....#.....#
#....#.....#.....#
#....#.....#.....#
#....#.....#.....#
#................#
#................#
#................#
######.....#######
#.._.#.....#.....#
#....#.....#.....#
#....#.....#.....#
#....#.....#.....#
#....#.....#.....#
#....#.....#.....#
#....#.....#.....#
#....#.....#.....#
#....#.....#.....#
#....#.....#.....#
#................#
#................#
#................#
######.....#######
#....#.....#._...#
#....#.....#.....#
#....#.....#.....#
#....#.....#.....#
#....#.....#.....#
#....#.....#.....#
#....#.....#.....#
#....#.....#.....#
#....#.....#.....#
#....#.....#.....#
#................#
#................#
#................#
##################