WWWWWWWWWWWWWWWWWWWWWWW
W        W   W        W
W        W   W        W
W    aaa W   W a      W
W        W   W        W
W        W A W        W
W        W   W        W
W        W   W        W
W        W   W        W
W        W   W        W
W   WWWWWW   WWWWWW   W
W                     W
W                     W
W                     W
WWWWWWWWWWWWWWWWWWWWWWW