############################
#.....................#@...#
#.....................#....#
#.....................#....#
#.....................#....#
#.....................#....#
#.....................#....#
#..........................#
#..........................#
#.....................#....#
#.....................#....#
#.....................#....#
#.....................#....#
#.....................#....#
#......###########....######
#......#_..................#
#......#...................#
#......#####################
#..........................#
#..........................#
#..........................#
#..........................#
#########..........#########
#..........................#
#..........................#
#..........................#
#......._..................#
#..........................#
#..........................#
#..........................#
#..........................#
############################
