########################################
#......................................#
#......................................#
#....##########........................#
#....#........#........................#
#....#........#........................#
#....#........#........................#
#....#.......@#........................#
#....#........#........................#
#....#........#........................#
#....#.................................#
#....#........#........................#
#....##########........................#
#......................................#
#......................................#
#........................##############.#
#........................#............#.#
#........................#............#.#
#........................ ............#.#
#........................#............#.#
#........................#............#.#
#........................#............#.#
#........................#............#.#
#........................#............#.#
#........................#............#.#
#........................#............#.#
#........................#............#.#
#........................#..._........#.#
#........................##############.#
#......................................#
#......................................#
#..####################................#
#..#..................#................#
#..#..................#................#
#..#..................#................#
#..#..................#................#
#..#..................#................#
#..#..................#................#
#..#..................#................#
#..#..................#................#
#..#..................#................#
#..#.........._........................#
#..#..................#................#
#..####################................#
#......................................#
#......................................#
########################################
