#################################
#...............................#
#..........................@....#
#...............................#
#...............................#
#.....###########################
#.....#._....#..............._..#
#.....#......#..................#
#.....#......#...#..............#
#.....#......#...#..............#
#_....#......#...#..............#
#.....#......#...#..............#
#.....#......#...#..............#
#.....#......#...#..............#
#.....#......#...#..............#
#.....#......#...#..............#
#.....#......#...#..............#
#.....#......#...#..............#
#.....#......#._.#..............#
#.#####......#####..............#
#...............................#
#...............................#
#...............................#
#...............................#
#################################
