WWWWWWWWWWWWWWWWWWWWWWWWWWWWWWWWW
W                W              W
W   A            W              W
W                W              W
W                W              W
W       W        W              W
W       W        W      W       W
W       W        W  g   W       W
W   a   W        W      W       W
WWWWWWWWW        WWWWWWWW       W
W                               W
W                               W
W                               W
W                    WWWWWWWWWWWW
W                    W          W
W                    W  m       W
W                    W          W
W                               W
W                               W
W                               W
WWWWWWWWWWWWWWWWWWWWWWWWWWWWWWWWW