WWWWWWWWWWWWWWWWWWWW
W                  W
W                  W
W                  W
W                  W
W                  W
W      W    W      W
W      W    W      W
W      W    W      W
W      W    W      W
W      W    W      W
W      W    W      W
W      W    W      W
W      W    W      W
W      W    W      W
W      W    W      W
W      W    W      W
W      W    W      W
W      W    W  a   W
WWWWWWWW     WWWWWWW 