WWWWWWWWWWWWWWWWWWWWWWW
W              B      W
W                     W
W    a A       r      W
W                 b   W
W                     W
W                     W
W              R      W
W                     W
W    g     G          W
W                     W
WWWWWWWWWWWWWWWWWWWWWWW