WWWWWWWWWWWWWWWWWWWWWWW
W                     W
W                     W
W    a A       r      W
W                     W
W               g     W
W                     W
W              R      W
W                     W
W                     W
W                     W
WWWWWWWWWWWWWWWWWWWWWWW