WWWWWWWWWWWWWWWWWWWWWWW
W                     W
W                     W
W    a A       r      W
W                     W
W                     W
W                     W
W     g        R      W
W                     W
W                     W
W                     W
WWWWWWWWWWWWWWWWWWWWWWW