WWWWWWWWWWWWWWWWWWW
W   W             W
W W W W W WWW W W W
W   W   W         W
W W W W W W W W W W
W  aW             W
W W W W W WWW W W W
W           W     W
W W WWWWWWW W WWW W
W           W     W
W W WWW W W W W W W
W W         W   W W
W W W W WWWWW W W W
W                 W
W WWWWW W WWWWW W W
W       W    A    W
W W WWW W W WWW W W
W                 W
WWWWWWWWWWWWWWWWWWW
