WWWWWWWWWWW
W       W W
W WWW W W W
W W   W   W
W W WWWWW W
W W   W   W
W WWW WWWWW
WaW W     W
W W WWWWW W
W       W W
WWWWWWWWW W
W       W W
W WWWWW W W
W   W W W W
WWW W W W W
W   W   W W
W WWW WWW W
W   W   W W
WWW WWW W W
WAW   W W W
W WWW W W W
W     W   W
WWWWWWWWWWW
