WWWWWWWWWWW
W         W
W W W W W W
Wa        W
W W W W W W
W     W   W
W WWW W W W
W         W
W W W W W W
W        AW
WWWWWWWWWWW
