WWWWWWWWWWWWWWW
W    a    W   W
W WWW W W W W W
W     W   W W W
W WWW W WWW W W
W   W W W     W
WWW W W W WWW W
W WA    W   W W
W WWW W WWW W W
W           W W
WWWWWWWWWWWWWWW
