WWWWWWWWWWWWWWWWWWWWWWWWWWWWWWWWWWWWWWW
WA                                    W
W W W W W W WWW W W W W W W W W WWWWW W
W         W       W   W W     W       W
W W W WWW W W W W W W W W W W WWW W W W
W W           W         W   W         W
W W W W W W W W WWWWWWW W W W W W WWW W
W       W                 W           W
W W WWW W WWWWW W W W W W WWW WWWWWWW W
W                 W W                 W
W W W W WWW W WWW W W W W W WWW W W W W
W           W W     W W         W     W
W WWW W W W W WWW W W W W W W WWW W W W
W   W       W   W   W       W         W
W W W W W WWWWW W W W W W W W W WWW W W
W   W           W   W   W   W W       W
W W W W W W W W W W W W W W W W W W W W
W   W       W                   W     W
W W W WWWWW W W W W WWWWWWWWWWW W WWW W
W W                             W     W
W W W W W W W W W W W W W W WWW WWW W W
W                 W                   W
W W W W W WWWWWWW WWW W W W W WWW WWW W
W   W   W W           W W     W       W
W W W W W W W W W W W W W W W W W W W W
W     W   W   W     W         W   W   W
W W W W W W WWW W W WWWWW WWW W WWW W W
W                                     W
W W WWW WWWWW WWW WWWWWWWWW WWW W W W W
W                               W W   W
W WWWWWWW W W W WWW W W W W WWW W W W W
W             W         W           W W
W W WWW WWW W W W W WWWWW W W WWW W W W
W             W           W   W     W W
W WWWWW W W W W WWW W WWW W W W WWW W W
W         W   W                       W
W W W W W W W W W W WWW W W W W W W W W
W                                    aW
WWWWWWWWWWWWWWWWWWWWWWWWWWWWWWWWWWWWWWW
