WWWWWWWWWWW
W   W     W
W WWW W W W
W     W W W
WWW WWW W W
WAW   W W W
W WWWWW WWW
W     W   W
WWWWW WWW W
W   W     W
W W WWWWW W
W W     W W
WWW WWWWW W
W   W     W
W W W WWWWW
WaW W   W W
W WWWWW W W
W         W
WWWWWWWWWWW
