WWWWWWWWWWWWWWWWWWWWWWW
WWWWWWWWWWWWWWWWWWWWWWW
WWA                  WW
WW W WWW W W WWW W W WW
WW         W   W W   WW
WW W W W W WWW WWW W WW
WW   W             W WW
WW W W WWWWW WWW WWW WW
WW             W     WW
WWWWWWWW W W W W W W WW
WW                  aWW
WWWWWWWWWWWWWWWWWWWWWWW
WWWWWWWWWWWWWWWWWWWWWWW
WWWWWWWWWWWWWWWWWWWWWWW
WWAW       WWWWWWWWWWWW
WW W W W W WWWWWWWWWWWW
WW   W     WWWWWWWWWWWW
WW W W W W WWWWWWWWWWWW
WW W W W   WWWWWWWWWWWW
WW W W WWW WWWWWWWWWWWW
WW         WWWWWWWWWWWW
WW W W W W WWWWWWWWWWWW
WW W W     WWWWWWWWWWWW
WW W W W W WWWWWWWWWWWW
WW         WWWWWWWWWWWW
WW WWWWW W WWWWWWWWWWWW
WW     W   WWWWWWWWWWWW
WWWWWW W W WWWWWWWWWWWW
WW     W   WWWWWWWWWWWW
WW W W W W WWWWWWWWWWWW
WW W   W   WWWWWWWWWWWW
WW WWW W W WWWWWWWWWWWW
WW        aWWWWWWWWWWWW
WWWWWWWWWWWWWWWWWWWWWWW
WWWWWWWWWWWWWWWWWWWWWWW
WWWWWWWWWWWWWWWWWWWWWWW
WWA  W         WWWWWWWW
WWWW W W W W W WWWWWWWW
WW W W       W WWWWWWWW
WW W WWW W W W WWWWWWWW
WW W     W     WWWWWWWW
WW WWWWW WWW W WWWWWWWW
WW     W       WWWWWWWW
WW W W W W W W WWWWWWWW
WW W W     W   WWWWWWWW
WW W W W W W W WWWWWWWW
WW W          aWWWWWWWW
WWWWWWWWWWWWWWWWWWWWWWW
WWWWWWWWWWWWWWWWWWWWWWW
