WWWWWWWWWWWWWWWWWWWWWWWWWWWWWWWWWWWWW
WWWWWWWWWWWWWWWWWWWWWWWWWWWWWWWWWWWWW
WWA                  WWWA        WWWW
WW W WWW W W W W WWW WWW W W WWW WWWW
WW W     W   W     W WWW         WWWW
WW W WWW W WWW WWW W WWW W W W W WWWW
WW           W   W   WWW W W     WWWW
WW WWWWWWWWW WWW W WWWWW W W W W WWWW
WW                   WWW         WWWW
WW W W W W WWW WWWWW WWW WWW W W WWWW
WW     W            aWWW W       WWWW
WWWWWWWWWWWWWWWWWWWWWWWW WWWWWWW WWWW
WWWWWWWWWWWWWWWWWWWWWWWW       W WWWW
WWWWWWWWWWWWWWWWWWWWWWWW W WWW W WWWW
WWWWWWWWWWWWWWWWWWWWWWWW       W WWWW
WWWWWWWWWWWWWWWWWWWWWWWWWWWW W W WWWW
WWWWWWWWWWWWWWWWWWWWWWWW       W WWWW
WWWWWWWWWWWWWWWWWWWWWWWW W W W W WWWW
WWWWWWWWWWWWWWWWWWWWWWWW   W     WWWW
WWWWWWWWWWWWWWWWWWWWWWWW W WWW W WWWW
WWWWWWWWWWWWWWWWWWWWWWWW        aWWWW
WWWWWWWWWWWWWWWWWWWWWWWWWWWWWWWWWWWWW
WWWWWWWWWWWWWWWWWWWWWWWWWWWWWWWWWWWWW
WWWWWWWWWWWWWWWWWWWWWWWWWWWWWWWWWWWWW
WWA  W         WWWWWWWWWA      W   WW
WWWW W W W W W WWWWWWWWW W W W W W WW
WW W W       W WWWWWWWWW   W W     WW
WW W WWW W W W WWWWWWWWW W W WWW W WW
WW W     W     WWWWWWWWW   W W     WW
WW WWWWW WWW W WWWWWWWWW W W W WWW WW
WW     W       WWWWWWWWW     W   W WW
WW W W W W W W WWWWWWWWW WWW WWW W WW
WW W W     W   WWWWWWWWW   W     W WW
WW W W W W W W WWWWWWWWW W W WWWWW WW
WW W          aWWWWWWWWW          aWW
WWWWWWWWWWWWWWWWWWWWWWWWWWWWWWWWWWWWW
WWWWWWWWWWWWWWWWWWWWWWWWWWWWWWWWWWWWW
