WWWWWWWWWWWWWWWWWWWWWWW
WWWWWWWWWWWWWWWWWWWWWWW
WWA            WWWWWWWW
WW W WWW W W W WWWWWWWW
WW W   W     W WWWWWWWW
WW W W W W W W WWWWWWWW
WW     W W   W WWWWWWWW
WW W W W WWWWW WWWWWWWW
WW W W         WWWWWWWW
WW W W W W W W WWWWWWWW
WW W       W W WWWWWWWW
WW W W WWW W W WWWWWWWW
WW           WaWWWWWWWW
WWWWWWWWWWWWWWWWWWWWWWW
WWWWWWWWWWWWWWWWWWWWWWW
WWWWWWWWWWWWWWWWWWWWWWW
WWA          W       WW
WW WWWWW W W W W WWW WW
WW       W     W     WW
WW WWW W W W W W W W WW
WW       W W         WW
WW W WWW W W WWWWWWW WW
WW       W       W   WW
WW W W W W W W W W W WW
WW   W W   W W W W   WW
WW W W WWW W W WWW W WW
WW   W       W       WW
WW W W W WWW WWW WWW WW
WW   W W   W W     W WW
WW W W WWW W W WWWWW WW
WW   W         W     WW
WW W W WWWWW W W WWW WW
WW                  aWW
WWWWWWWWWWWWWWWWWWWWWWW
WWWWWWWWWWWWWWWWWWWWWWW
WWWWWWWWWWWWWWWWWWWWWWW
WWA  W           W WWWW
WW W W W W W WWW W WWWW
WW W               WWWW
WW WWWWWWW W W W W WWWW
WW       W   W     WWWW
WW WWW W W W W W W WWWW
WW       W W   W W WWWW
WW W WWWWW W W W W WWWW
WW       W   W W W WWWW
WW WWW W W WWW W W WWWW
WW               W WWWW
WW WWW WWW WWW W W WWWW
WW       W W   W   WWWW
WW W WWW W W W W W WWWW
WW               WaWWWW
WWWWWWWWWWWWWWWWWWWWWWW
WWWWWWWWWWWWWWWWWWWWWWW
