#####
##.n#
#m@B#
#####
#####
