#####
#m.n#
#b@B#
#g.G#
#####
