#####
##.n#
#b@B#
#####
#####
