#####
##.n#
#m@B#
##.G#
#####
