#####
##.n#
#m@B#
##.G#
##.L#
#####
