############################################################
############################################################
############################################################
############################################################
############################################################
################.######...#####...######..####..##...#######
#########..####....####.....##.....#..##..###......H.#######
########...###.....###.......#........##...###.......#######
#######....##.....####.C.O...#.H............####.C....######
#######.......##..##........##...............###......######
#######....#..##.....S...#..##......#.........#####..#######
######...........#.......##................###.####..#######
######...S.#.H....###...###............##...##...#....######
######.............####.##.......##....###.....#.....#######
######.....##.##.#...#..###....####..O.###........##########
#####....######.......#######.##.#........#.......##########
#####....####..#...C..#########......#....#..#.O...#########
#####....###...##....#.....#.......#........#..........#####
#####.....##.H..#............H.H.........#.........#.C.#####
######.....#...#.#.............................###.....#####
#######..##..##....#.G.#.......###.H........##..##.G.#######
#######..#...###.........#.....##....####...######...#######
#######....C.#....#.###...##......########.###..############
######........###....##.............##..#####.#..###########
######.....###..#..####.c.........o.##.##.##......##########
#####.......##.......##.............#..##...#......#########
######.....###........#......H......#C.#...#........########
#####......###.##.....#......@......#...#..#....##.....#####
#####.......######...........................##.##.....#####
######.###..###............@.+.@.............##.##.....#####
###########..##..#.C...........................###.....#####
###########..####............@......#.####......#.#....#####
########......###.#..........=......#.####........##...#####
########...###....##.........L......#..##...###.......######
########...##..G..#...#.g....M....s.#......###.##..H..######
#########.####........#......C......##..#.#..#.#.......#####
###########...##....#.#####..O....###..##..#...#.###..######
#########....##...###...#............#.#####....###....#####
#######....C..#.######.....#.H.S.S.....#####.##......G.#####
#######........#####.##....#.......#.....##..###.......#####
######.......C.#..##.#.........#####.O..###.#####.#....#####
#####.....#........#...........###.........###..###....#####
#####........G.#......#........####...###.###..#.##....#####
#####..........#......#.#.......###....#.###.#...#....######
#####......###.....#..###............O.....#..##.......#####
######.....###....##..##...#...............#..####....######
######.O..####....######.S.###.#.G...#..#......####.########
######.....####..#..##...............#.#.....#...###########
#######.....####.##.##.......###.##...#....##...#.##########
#####......#.....#.......H..##...####.#....###....##########
#####...####...C.#.G...........G..####.....##.....##########
######..####.....#....###.........####............##########
######..####.G.#########....##......##..........#...########
######..####...#####..##...#####....##.......#####..########
####################......############...##.######..########
############################################################
############################################################
############################################################
############################################################
############################################################
