############################################################
############################################################
############################################################
############################################################
############################################################
################.######...#####...######..####..##...#######
#########..####....####.....##.....#..##..###......H.#######
########...###.....###.......#........##...###.......#######
#######....##.....####.N.O...#.H............####.N....######
#######.......##..##........##...............###......######
#######....#..##.....I...#..##......#.........#####..#######
######...........#.......##................###.####..#######
######...I.#.H....###...###............##...##...#....######
######.............####.##.......##....###.....#.....#######
######.....##.##.#...#..###....####..O.###........##########
#####....######.......#######.##.#........#.......##########
#####....####..#...N..#########......#....#..#.O...#########
#####....###...##....#.....#.......#........#..........#####
#####.....##.H..#............H.H.........#.........#.N.#####
######.....#...#.#.............................###.....#####
#######..##..##....#.E.#.......###.H........##..##.E.#######
#######..#...###.........#.....##....####...######...#######
#######....N.#....#.###...##......########.###..############
######........###....##.............##..#####.#..###########
######.....###..#..####.K.........Q.##.##.##......##########
#####.......##.......##.............#..##...#......#########
######.....###........#......H......#N.#...#........########
#####......###.##.....#......@......#...#..#....##.....#####
#####.......######...........................##.##.....#####
######.###..###............@.Z.@.............##.##.....#####
###########..##..#.N...........................###.....#####
###########..####............@......#.####......#.#....#####
########......###.#..........C......#.####........##...#####
########...###....##................#..##...###.......######
########...##..E..#...#.Y.........V.#......###.##..H..######
#########.####........#.............##..#.#..#.#.......#####
###########...##....#.######......###..##..#...#.###..######
#########....##...###...#............#.#####....###....#####
#######....N..#.######.....#.H.I.I.....#####.##......E.#####
#######........#####.##....#.......#.....##..###.......#####
######.......N.#..##.#.........#####.O..###.#####.#....#####
#####.....#........#...........###.........###..###....#####
#####........E.#......#........####...###.###..#.##....#####
#####..........#......#.#.......###....#.###.#...#....######
#####......###.....#..###............O.....#..##.......#####
######.....###....##..##...#...............#..####....######
######.O..####....######.I.###.#.E...#..#......####.########
######.....####..#..##...............#.#.....#...###########
#######.....####.##.##.......###.##...#....##...#.##########
#####......#.....#.......H..##...####.#....###....##########
#####...####...N.#.E...........E..####.....##.....##########
######..####.....#....###.........####............##########
######..####.E.#########....##......##..........#...########
######..####...#####..##...#####....##.......#####..########
####################......############...##.######..########
############################################################
############################################################
############################################################
############################################################
############################################################
