############################################################
############################################################
############################################################
############################################################
############################################################
################.######...#####...######..####..##...#######
#########..####....####.....##.....#..##..###......+.#######
########...###.....###.......#........##...###.......#######
#######....##.....####.C.O...#.+............####.C....######
#######.......##..##........##...............###......######
#######....#..##.....S...#..##......#.........#####..#######
######...........#.......##................###.####..#######
######...S.#.+....###...###............##...##...#....######
######.............####.##.......##....###.....#.....#######
######.....##.##.#...#..###....####..O.###........##########
#####....######.......#######.##.#........#.......##########
#####....####..#...C..#########......#....#..#.O...#########
#####....###...##....#.....#.......#........#..........#####
#####.....##.+..#............+.+.........#.........#.C.#####
######.....#...#.#.............................###.....#####
#######..##..##....#.G.#.......###.+........##..##.G.#######
#######..#...###.........#.....##....####...######...#######
#######....C.#....#.###...##......########.###..############
######........###....##.............##..#####.#..###########
######.....###..#..####.c.........o.##.##.##......##########
#####.......##.......##.............#..##...#......#########
######.....###........#......+......#C.#...#........########
#####......###.##.....#......@......#...#..#....##.....#####
#####.......######...........................##.##.....#####
######.###..###............@.&.@.............##.##.....#####
###########..##..#.C...........................###.....#####
###########..####............@......#.####......#.#....#####
########......###.#..........=......#.####........##...#####
########...###....##.........L......#..##...###.......######
########...##..G..#...#.g....M....s.#......###.##..+..######
#########.####........#......C......##..#.#..#.#.......#####
###########...##....#.#####..O....###..##..#...#.###..######
#########....##...###...#............#.#####....###....#####
#######....C..#.######.....#.+.S.S.....#####.##......G.#####
#######........#####.##....#.......#.....##..###.......#####
######.......C.#..##.#.........#####.O..###.#####.#....#####
#####.....#........#...........###.........###..###....#####
#####........G.#......#........####...###.###..#.##....#####
#####..........#......#.#.......###....#.###.#...#....######
#####......###.....#..###............O.....#..##.......#####
######.....###....##..##...#...............#..####....######
######.O..####....######.S.###.#.G...#..#......####.########
######.....####..#..##...............#.#.....#...###########
#######.....####.##.##.......###.##...#....##...#.##########
#####......#.....#.......+..##...####.#....###....##########
#####...####...C.#.G...........G..####.....##.....##########
######..####.....#....###.........####............##########
######..####.G.#########....##......##..........#...########
######..####...#####..##...#####....##.......#####..########
####################......############...##.######..########
############################################################
############################################################
############################################################
############################################################
############################################################
