type: mettagrid.map_builder.ascii.AsciiMapBuilder.Config
map_data: |-
  ########################################
  ########################################
  ########################################
  #####.G#################################
  #####.##################################
  #####..###..#####...#######.####..######
  #####........####.O.######...###..######
  #######.####..###...#.###..G..##...#####
  #########..#..#..##.............+..#####
  #######..#.#.##.##...#########....######
  #######.+#...................#....######
  ######.....C...............O.##....#####
  ######.#.#...................##....#####
  #####...##...................#....######
  #####...##...................##.########
  #####...##...................##...######
  ######..##.........+.........##.+.######
  ########.#.........@.........#....######
  ########........................+..#####
  ######...........@.&.@.............#####
  ######..#..........................#####
  #####..###.........@.........###..######
  #####..###.........=.........##..#######
  #####..###...................#..########
  #####...##...................#..########
  ######..##...................#.#########
  #######..#...................#.....#####
  #####....#.G...............S.#.....#####
  #####...##...................#.....#####
  #######.##.#.#####...#########....######
  #######.#..#..#..###.####.........######
  #######.####..#.##...####.....S...######
  #######....###........#####........#####
  ######...C...##.###.....#####...#.######
  #######......######..#..################
  ########################################
  ########################################
  ########################################
  ########################################
  ########################################
char_to_name_map:
  "#": wall
  ".": empty
  "@": agent.agent
  "+": charger
  "&": assembler
  "=": chest
  "G": germanium_extractor
  "S": silicon_extractor
  "O": oxygen_extractor
  "C": carbon_extractor
