type: mettagrid.map_builder.ascii.AsciiMapBuilder
map_data: |-
  ##################################################################################################################################################################################################################
  ##################################################################################################################################################################################################################
  ##################################################################################################################################################################################################################
  ##################################################################################################################################################################################################################
  #################################################################################CCC############OOO#########SSS#################GGG###############################################################################
  #####..####.#.....#...#.#......#.....#####....................####.....C................................................................###..........#.................###.#..#..###.....#.....##.........########
  #####...............O....#..#.................................####............................C...............................+.........####....#..............#........#........##......##....##.....##..########
  #####.................#..#..#..#....#.........................###.......................................................................+.#....##.#....#...............#..........#.#....#...#.........###########
  #####.........#...#...........#.#..#..........####....####....###.G...###########.......................................................#...#............#.............#..........##..........#.##...###.#..######
  #####.........#.......#.......................####....####....###.....###########.......................................................+.......................##.#.........#....###.......#.#.##..####....######
  #####..###..#...+..#.##....##.#.#..#.####.C...####....####....####....###########................######...######........................#..........#....#......###..#..#.....#.#.###.#...###...##....###....######
  #####..####.......##.#........##.....####.....####....####....####....###########................#.............#........................#........#.#.#####.....####........####.........###....####.....##..######
  #####..###.......###..###...S..#.....#####....####....####....####...............................#.C.........O.#......S.................#.G......#.##.###...O..............###....##.#..###.######.#..G.##..######
  #####..####......######.......###....#####....####....####....####...............................#.............#..............C.........#.........#.#.#..##...........#.....#............##.###....#.........#####
  #####..####......######....######....#####....####....####....####.......S.......................#......+......#........................###...S...#....#...##.#..#........#.....G.........##.#..............######
  #####..####......######..............#####....####....####....####...............C...............#......@......#........................####.................#.#..##...###..........#....##....#.#.#.........#####
  #####...........................C.............####....####....####....####..............................................................####.##.+.....G......................................................#####
  #####.........................................####....####....####....####............................@.&.@..............................###..#..............................................................#####
  ######................##..##......C.#..###....####....####....####....####................O.................................................###.###..........................................................#####
  ########..##....#.....##..#.........######....####....####....####....####.......................#......@......#.........................#...#..###..........######......######......######......##.###......#####
  #########.#.#....###.#.....#........######..........#.....#...####..............#................#......=......#..............C.........##....##.............######......######......######......##.###......#####
  ##########.....#.#....#..........#..#####...##....##......###.####..#....###......................#.............#........................#..#...####..........######......####........######.#....##..##.....#####
  ##########......#......#....#..###...##...O..#......#...#..#..######.....##....#.#................#.G.........S.#....S...................####.#.#..#.+..###...#####.....#.###..G...#..###.........#######....#####
  #########......#.......#.#........##.#..#...#...........#.#...####....##....##..................#.............#........................###...#.#.............######.........#...........####.....###.##......#####
  #####....................####......##...###...+.....#..#..#..####.G.#########..##................######...######........................#..#...........#.....######..#....+.###.##..G..###...#...###..#......#####
  #####...................######.....##....#..#.....#....###..#####.......#.......#.......................................................##.#..........#..........#...........................#....#.#........#####
  #####...................#####...##.#..............##...###...######.............#.................O........................S............#.......#...........................O..........#.#...................#####
  #####....##.............#####...##........#......###...###.#.######......O..............................................................#..........##..........#..........#....#......#...#..................#####
  #####.............+.##...###....##...#....#......##.......#..###................O.......+...............................................#..........##...#.......................##..............##......##########
  #####......#........###.........#.................##.....##..##...............#.........................................................#..........##.#.##......................##..............##......##########
  #####.........#...######........#......#.#......#..##..#..#..##.......#.......###.......................................................#......##....#####..+...................##............O.##..G...##########
  #####.............#####............#............#..##.##..#..##.....#.....#...###.......C........C......................................##........#.#####.......................##..............##......##########
  #####.....G...........................###.......#...#....##..###.......##......##..##........................#####............#.........########......#.....+...................##..............##......##########
  #####...........#....###..#........#.###...#.##.#.##.....##..####......#.......######.##..#..................#####.........#........#...####..##................................##..............##......##########
  ##################################################################################################################################################################################################################
  ##################################################################################################################################################################################################################
  ##################################################################################################################################################################################################################
  ##################################################################################################################################################################################################################
  ##################################################################################################################################################################################################################
char_to_name_map:
  "#": wall
  ".": empty
  "O": oxygen_extractor
  "G": germanium_extractor
  "+": charger
  "C": carbon_extractor
  "S": silicon_extractor
  "@": agent.agent
  "&": assembler
  "=": chest
