type: mettagrid.map_builder.ascii.AsciiMapBuilder
map_data: |-
    #################################################################
    #..................................#............................#
    #.........##.......................#....................#.......#
    #.........##.......................##....................#......#
    #........####.......................##..........................#
    #........#.##........................#..###.....................#
    #........######........#.............####.#.....................#
    #..##....#######.......#..................###...................#
    #...#....##....#.......#....................########............#
    #....#.................#...........................#....#.......#
    #.....##.............###...........................#............#
    #......##..............#..................########.#............#
    #.......#..............#..................#......###............#
    #......................#..................#.......##.....#......#
    #.........................................#.....................#
    #..####...................................##....................#
    #..#.......................................#....................#
    #..#.......................................#....................#
    #..#.....#.................................#....................#
    #..#.....##.....................................................#
    #..#......##....................................................#
    #..........#....................................................#
    #...........#......................................#########....#
    #............#..................................................#
    #.............#.........####.......####.........................#
    #.....#.......##........#.G.........O.#.........................#
    #.....#.................#.............#.........................#
    #.....#.................#......=......#.........................#
    #.....#.........................................................#
    #.....#........................@................................#
    #..............................&................................#
    #...............................................................#
    #...............................................................#
    #..............................+................................#
    #.......................#.............#.........................#
    #.......................#C...........S#.........................#
    #.......................#.............#................#........#
    #.......................####.......####................#........#
    #.............##.......................................##.......#
    #.........#####.........................................#.......#
    #.........#.............................................#.......#
    #.........#.............................................#.......#
    #........#.........................................######.......#
    #.......##...........###.##########................#............#
    #.......#...........##............#................#............#
    #.......#...........#..............#...............#............#
    #......##...........#..............#...............#............#
    #......#............#..............#............................#
    #......##..........................#............................#
    #.......#..........................##...........................#
    #.......##...#......#...............#...........................#
    #...##...#..........#...............#.........#.................#
    #....#....#.........##..............#...........................#
    #....##.###..........#..............#.....................##....#
    #.....###.#..........#..............#.................#...##....#
    #..............#.....#..............#........#####........###...#
    #....#.......#.......#.......#...............#####......#.###...#
    #............................................#............#######
    #..#.........................................#............###.###
    #......#...#............#.........#......#...#.................##
    #...............................................................#
    #...............................................................#
    #...............................................................#
    #...............................................................#
    #################################################################
char_to_name_map:
  "#": wall
  ".": empty
  "O": oxygen_extractor
  "G": germanium_extractor
  "+": charger
  "C": carbon_extractor
  "S": silicon_extractor
  "@": agent.agent
  "&": assembler
  "=": chest

