type: mettagrid.map_builder.ascii.AsciiMapBuilder
map_data: |-
    ########################################
    #+.................................#..+#
    #.#.........................#..........#
    #.#..O........................#....#O#.#
    #..#.........####.......G...........#..#
    #..#...#.....######..........#.........#
    #......#...######.#...S..#.....S....S..#
    #......#...######.##............##.....#
    #....###......####.......#....#....#...#
    #............#.....................#...#
    #.#####................................#
    #.............................#...#....#
    #.....####.............................#
    #........#.............................#
    #........#.....###.....###.............#
    #........#.....#O.......G#.............#
    #.....#........#....=....#......#......#
    #.....#.........................##.....#
    #.....#.............&............##....#
    #.....#.............@.............#....#
    #.....#................................#
    #.....#.............+..................#
    #..........#...#C.......S#.............#
    #..........#...#.........#.............#
    #..........#...###.....###.............#
    #.....#....#.................#.........#
    #.....#....#..................##.......#
    #..........#...................##......#
    #..............#####............##.....#
    #..............#...#......##.....##....#
    #..............#...#.....#.##......#...#
    #....######....#...#....##..##....##...#
    #.........###..#...#....#....###.##....#
    #..............#...#....##.....###.....#
    #..............#.........##............#
    #.........................###..........#
    #...........................##.........#
    #......................................#
    #......................................#
    ########################################
char_to_name_map:
  "#": wall
  ".": empty
  "+": charger
  "O": oxygen_extractor
  "G": germanium_extractor
  "C": carbon_extractor
  "S": silicon_extractor
  "@": agent.agent
  "&": assembler
  "=": chest

