type: mettagrid.map_builder.ascii.AsciiMapBuilder
map_data: |-
  ###########################
  ###########################
  ###########################
  ###########.......#########
  ###########..+.+..#########
  ###########...@...#########
  ###########..&=&..#########
  ###########...@...#########
  ###########..+.+..#########
  ###########.......#########
  #####..g............S######
  #####........G........#####
  #####S.............C..#####
  #####......O..............#
  #####...........S.........#
  #....G....................#
  #..............C.......S..#
  #..S...............O......#
  #........G................#
  #########################.#
  #########################.#
  #########################.#
char_to_name_map:
  "#": wall
  ".": empty
  "+": charger
  "@": agent.agent
  "&": assembler
  "=": chest
  "g": depleted_germanium_extractor
  "G": germanium_extractor
  "S": silicon_extractor
  "C": carbon_extractor
  "O": oxygen_extractor


