#####################
#####################
#####################
#####################
#####################
#####...........#####
#####...........#####
#####..K..H..Q..#####
#####.....@.....#####
#####...........#####
#####...@.Z.@...#####
#####...........#####
#####.....@.....#####
#####..Y..C..V..#####
#####...........#####
#####...........#####
#####################
#####################
#####################
#####################
#####################
