###############################
###############################
###############################
###############################
###############################
#####.....................#####
#####.....................#####
#####..c...............o..#####
#####.....................#####
#####.....................#####
#####.....................#####
#####.....................#####
#####..........H..........#####
#####..........@..........#####
#####.....................#####
#####........@.+.@........#####
#####.....................#####
#####..........@..........#####
#####..........=..........#####
#####.....................#####
#####.....................#####
#####.....................#####
#####.....................#####
#####..g...............s..#####
#####.....................#####
#####.....................#####
###############################
###############################
###############################
###############################
###############################
