type: mettagrid.map_builder.ascii.AsciiMapBuilder.Config
map_data: |-
  ###########################
  ###########################
  #####.................#####
  #####...###.....###...#####
  #####...#x#.....#y#...#####
  #####...###.C+..###...#####
  #####.................#####
  #####..#############..#####
  #####.#.............#.#####
  #####.#..###.###..#...#####
  #####..#.#.....#.#....#####
  #####..#.#..+=..#.#...#####
  #####..#.@..&..@.#....#####
  #####..#.#.@.@.#.#....#####
  #####..#.#.....#.#....#####
  #####.#..###.###..#...#####
  #####.#.............#.#####
  #####..#############..#####
  #####.................#####
  #####...###.C+..###...#####
  #####...#z#.....#q#...#####
  #####...###.....###...#####
  #####.................#####
  ###########################
  ###########################
char_to_map_name:
  "#": wall
  ".": empty
  "x": clipped_carbon_extractor
  "y": clipped_oxygen_extractor
  "z": clipped_germanium_extractor
  "q": clipped_silicon_extractor
  "C": charger
  "+": charger
  "=": chest
  "&": assembler
  "@": agent.agent

