type: mettagrid.map_builder.ascii.AsciiMapBuilder
map_data: |-
  #####################
  #####################
  #####################
  #####################
  ####...#######...####
  ####.c....@....o.####
  ####...##...##...####
  #####.#.......#.#####
  #####.#...+...#.#####
  #####...........#####
  #####@....&....@#####
  #####...........#####
  #####.#...=...#.#####
  #####.#.......#.#####
  ####...##...##...####
  ####.g....@....s.####
  ####...#######...####
  #####################
  #####################
  #####################
  #####################
char_to_name_map:
  "#": wall
  ".": empty
  "c": carbon_ex_dep
  "@": agent.agent
  "o": oxygen_ex_dep
  "+": charger
  "&": assembler
  "=": chest
  "g": germanium_ex_dep
  "s": silicon_ex_dep
