map_data: |-
  #####################
  #####################
  #####################
  #####################
  #####################
  #####.....@.....#####
  #####.###...###.#####
  #####.#.......#.#####
  #####.#.c.+.o.#.#####
  #####...........#####
  #####@....&....@#####
  #####...........#####
  #####.#.g.=.s.#.#####
  #####.#.......#.#####
  #####.###...###.#####
  #####.....@.....#####
  #####################
  #####################
  #####################
  #####################
  #####################
char_to_name_map:
  "#": wall
  ".": empty
  "@": agent.agent
  "c": carbon_ex_dep
  "+": charger
  "o": oxygen_ex_dep
  "&": assembler
  "g": germanium_ex_dep
  "=": chest
  "s": silicon_ex_dep
