###############################
###############################
###############################
###############################
###############################
#####.....................#####
#####.....................#####
#####..K...............Q..#####
#####.....................#####
#####.....................#####
#####.....................#####
#####.....................#####
#####..........H..........#####
#####..........@..........#####
#####.....................#####
#####........@.Z.@........#####
#####.....................#####
#####..........@..........#####
#####..........C..........#####
#####.....................#####
#####.....................#####
#####.....................#####
#####.....................#####
#####..Y...............V..#####
#####.....................#####
#####.....................#####
###############################
###############################
###############################
###############################
###############################
