###############################
###############################
###############################
###############################
###############################
#####.....................#####
#####.....................#####
#####..B.......P.......N..#####
#####.....................#####
#####.....................#####
#####.....................#####
#####.....................#####
#####..........+..........#####
#####.......%%%%%%%.......#####
#####.....................#####
#####..D.....%.&.%.....T..#####
#####.....................#####
#####.......%%%%%%%.......#####
#####..........=..........#####
#####.....................#####
#####.....................#####
#####.....................#####
#####.....................#####
#####..F.......H.......R..#####
#####.....................#####
#####.....................#####
###############################
###############################
###############################
###############################
###############################
