#####################
#####################
#####################
#####################
#####################
#####.....@.....#####
#####.###...###.#####
#####.#.......#.#####
#####.#.c.H.o.#.#####
#####...........#####
#####@....+....@#####
#####...........#####
#####.#.g.=.s.#.#####
#####.#.......#.#####
#####.###...###.#####
#####.....@.....#####
#####################
#####################
#####################
#####################
#####################
