type: mettagrid.map_builder.ascii.AsciiMapBuilder
map_data: |-
  #####################
  #####################
  #####################
  #####################
  #####################
  #####.....@.....#####
  #####.####.####.#####
  #####.#.......#.#####
  #####.#.c.+.o.#.#####
  #####.#.......#.#####
  #####@..#.&.#..@#####
  #####.#.......#.#####
  #####.#.g.=.s.#.#####
  #####.#.......#.#####
  #####.####.####.#####
  #####.....@.....#####
  #####################
  #####################
  #####################
  #####################
  #####################
char_to_name_map:
  "#": wall
  ".": empty
  "@": agent.agent
  "c": converter
  "+": wall
  "o": altar
  "&": altar
  "g": generator
  "=": wall
  "s": swappable_wall
