type: mettagrid.map_builder.ascii.AsciiMapBuilder
map_data: |-
  #########################################
  #####...............................#####
  #####...............+...............#####
  #####...............................#####
  #####...............................#####
  #####...............................#####
  #####...............................#####
  #####...............................#####
  #####...............@...............#####
  #####...............................#####
  #####...............&...............#####
  #####...............................#####
  #####...............@...............#####
  #####...............................#####
  #####...............................#####
  #####...............=...............#####
  #####...............................#####
  #####...............................#####
  #####...............=...............#####
  #####...............................#####
  #########################################
  #########################################
  #########################################
  #########################################
char_to_name_map:
  "#": wall
  ".": empty
  "+": charger
  "@": agent.agent
  "&": assembler
  "=": chest
