################################################################################################################################################################################################################################################################
################################################################################################################################################################################################################################################################
#########################.....###################..########################....####...........#########..##############################..###########.........#####............#####...........##########....###...####....########################............##
##################.######.....############..#####...######################..........##....##...#####......##########################......#######.....#.......###..#########...###....###......########.....##.....##......#######################..##.###.##.##
#################..######......###########...####....####################..........####..####..####.......#############..##########.......#######....#.........##..#########...##..#.#####.#...########.....................######################..##.###.##.##
#######....................................................#######....##...........####..####.......................................................#.#.#.#.#..##..#########...##..............######.........................#######.############............##
#######.#########..............####.######...........#####.######..................####..####..####.......##########.##..##########.......#######....#.........##..#########...##..#.#...#.#...######.#........................######.############............##
#######.##########............#####.######..........######.######..............................#####......##########.###############......#######.....#.......###.....#........###.............######.#.....##.....##..........######.############............##
#######.##########............#####.#######........#######.#######....##.......####...........#########..###########.##################..###########.........#####....#.......#####...........#######.##....###...####........#######.############............##
#######.###############.###########.######################.#########################################################.########################################################.#########.#############.#######################.#######.##################.#######
#######.###############.###########.######################.#########################################################.########################################################.#########.#############.#######################.#######.##################.#######
#######.###############.###########.######################.#########################################################.########################################################.#########.#############.#######################.#######.##################.#######
#######.###############.###########.######################.#########################################################.########################################################.#########.#############.#######################.#######.##################.#######
###...........................#####.####...........#######.####...............##########..##..####..##..#######...##.########################################################.#####..........#####..................#########.#######.####....................##
##..#......##..##..##.......#..####.###..##.##.##...######.###.................#########................######.....#.########################################################.####...#........###....................########.#######.###.........##.###..##..##
#.....#....##..##..##.....#....####.##...##.##.##....#####.##......#..#..#...#.#########................#####......#.########################################################.####.#....#.#...###......#.#.#.#.......#####.............##.........##.###..##..##
#...#...#...............#...#..###...............................................##..##..............................................................................................#......#......................#.##.......................................##
#.....#.....##....##......#....##.........##.##....................#..#..#...#.............................##..................................................................###.#....#.#...###......#.#.#.#.......#...################...........##..##.##.##
##..#.......##....##........#..##.........##.##............................................................###..........................###############################........###...#........###....................#...################...........##..##.##.##
###...........................####...............................................##..##...##..####..##.....####.........................###############################........####..........#####..................###..################.....................##
##########################################################################.########.#########.#########################....############################################################.###########.##############.####..#######################################
##########################################################################.########.#########.#########################....############################################################.###########.##############.####..#######################################
##########################################################################.########.#########.#########################....########################################################################.##############.####..#######################################
##########################################################################.########.#########.#########################....########################################################################.##############.####..#######################################
###...........................####............####.....####........##.........................####...####.#############....###................#.............................................................######.#.....########################............###
##.#..#..#..#......#..#..#..#.####....####....###.......##.....................................##.....##..#############....###.............#..........................................................####..######.#.....########################.##.###.##..###
##............................####.##########.###...#...##........#..#..#..#..#...#..#..#..#...##............................................#.......................................................######.######.#.....########################.##.###.##..###
##.#..#..#..#......#..#..#..#.####............###..#.#..##.....................................##..........................................#.........................................................######..............................########............###
##............................####.###....###.###...#...##........#..#..#..#..#...#..#..#..#...##........##############################......#.......................................................######..............................########............###
##.#..#..#..#......#..#..#..#.####............###.......##.....................................##.....##.##############################....#.............................................................................................########............###
##............................####............####.....####........##.........................####...##################################.......#..........................................................................................########............###
##............####............#########.##############.######.######################.#############..###################################..#########################.............##.............#########################..#########.......#############.#########
##............####............#########.##############.######.######################.#############..###################################..#########################.............##.............#########################..#########.......#############.#########
##............####............#########.##############.######.######################.#############..###################################..#########################.............##.............#########################..#########.......#############.#########
##............####............#########.##############.######.######################.#############..###################################..#########################.............##.............#########################..#########.......#############.#########
##............................#########.#..#######............####............######.#############..##############............#########...#....###............####............................#####...........###..............###.......#############.#########
##.#..#..#..#......#..#..#..#.####..###.#...######............###.............######.#############..##############.##.###.##..#########........##....######....###............................####....###......##.#.#......#...###.......#############.#########
##...................................##.#....#####.#.#.#.#.#..###.#.#.#........#####.....................#########.##.###.##..#########.....#..##..#.######.#..###............................###..#.#####.#...##.....#..#...#.###.......#############.#########
##.#..#..#..#......#..#..#..#.................................###..............#####.....................#########.............................##....######....###............................###..............##.#.#......#...###.......................#######
##...........................................#####.#.#.#.#.#..###.#.#.#..#########################################..##...##...#########.....#..##..#.######.#..###............................###..#.#...#.#...##............#.###.......................#######
##.#..#..#..#......#..#..#..#.####...........#####............###........#########################################..##...##...#########........##..............###............................####.............##.#.#......#...###.......................#######
##............................#####..........#####............####.......#########################################............#########...#....###............####............................#####...........###..............####......................#######
##............####............##########################################.##############################################################..##############..##############..###################..#########.#########.#.#.#..#.#.#.######################....#######
##............####............##########################################.##############################################################..##############..##############..###################..#########.#########.#.#.#..#.#.#.######################....#######
##............####............##########################################.##############################################################..##############..##############..###################..#########.#########.#.#.#..#.#.#.######################....#######
##............####............##########################################.##############################################################..##############..##############..###################..#########.#########.#.#.#..#.#.#.######################....#######
##............................####............####............####.......#########............#########################################......#####...##..##########..........####.........##..####....#.###..####..............###............######.....#######
##.#..#..#..#......#..#..#..#.###....######....##....######....##........#########..##.###.##.#########################################......#####...##..#########............###.....#...##..####....#.###..####.....#....#...##..............#####.....#######
##............................###..#.######.#..##..#.######.#..##..#.#...#########..##.###.##.#########################################......#####...................#....#.............#.##..###.....#.###..###..#.#....#...#.......#....#....#####.....#######
##.#..#..#..#......#..#..#..#.###....######....##....######....##........#########............#########......................................#####.#..............................#...#...##..###.....................#....#...................####......#.#.###
##............................###..#.######.#..##..#.######.#..##..#.#...#########............#########......................................#####...................#....#.............#.##..###............###..#.#....#...#.................###.......#######
##.#..#..#..#......#..#..#..#.###..............##..............##........#########............#########..##########################..........#####...##..#########............###.....#...##..####...........####.....#....#...##..............###.......#######
###...........................####............####............####.......#########............#########..##########################..........#####...##..##########..........####.........##..####...........####..............###............#####......#######
##############.########################..##############..##############..###############.##############..##############################..##############..########################.#...#.#.##..#####################.########.########################....#######
##############.########################..##############..##############..###############.##############..##############################..##############..########################.#...#.#.##..#####################.########.########################....#######
##############.########################..##############..##############..##############################..##############################..##############..########################.#...#.#.##..#####################.########.########################....#######
##############.########################..##############..##############..##############################..##############################..##############..########################.#...#.#.##..#####################.########.########################....#######
##############.###..........######............................####.......##############################........................................########..##########..........................................######.########.#####......####..######.....#######
##############.##...........######..##############.............###...#...##############################................#.#...#.##.#...#..#.#...########..##########.......................#....#############.######.########.####........##....#####.....#######
##############.##..#.#.#.#..........##############....#..................###############.##############...#.##...............................................................#....#...#.#......#############........................#.......#..#####.....#######
##.............##...................##############........#..........#...............##............................#.#.#.#.#.#.##.#.#.#..#.#.#............................................#....#############...................................####......#.#.###
##.............##..#.#.#.#..........##############....#.......................####...##.......#####.......#.##...........................................##############......#....#...#.#......#############........................#.......#..###.......#######
##.............##...........######..##############.............###...#........####...##.......#####....................#.#...#.##.#...#..#.#...########..##############...................#....#############.######.########.####........##....###.......#######
##.............###..........######............................####............####...##.......#####............................................########..##############..............................#######.######.########.#####......####..#####......#######
##............############..#########..##.....######..#...#.#.#####..####..##.####...##...#.#.#####################################.#.#..#.#.#.########..##############....###.##.#...#.#.##.#######.#######.######.########.########################....#######
##............############..#########..##.....######..#...#.#.#####..####..##.####...##...#.#.#####################################.#.#..#.#.#.########..##############....###.##.#...#.#.##.#######.#######.######.########.########################....#######
##............############..#########..##.....######..#...#.#.#####..####..##.####...##...#.#.#####################################.#.#..#.#.#.########..##############....###.##.#...#.#.##.#######.#######.######.########.########################....#######
##............############..#########..##.....######..#...#.#.#####..####..##.####...##...#.#.#####################################.#.#..#.#.#.########..##############....###.##.#...#.#.##.#######.#######.######.########.########################....#######
##............############..#########...#.....####............#####..................##.......................####.......##...####.............###.......##############.......................######.##...................#..#####.......................#######
##.............###########..#########...#..........#......#....###...................##...#........####........##..#.#......#..##...#....#...#.##....#...##############...................#....#####.#.......#####..########.####..###...................#######
##......................................#.............#...............#..............##.....#...........###.......................#...............#......##############.....#.....#...#.#............#.......#####..########..............####...........#######
##......................................#..........#......#.#.............................#........####............#.#......#.......#.#..#.#.#.......#....................................#..........#.......#####..########.......###.##................#######
##......................................#.............#...............#..............##.....#...........###.......................#...............#.........................#.....#...#.#............#.......#####..########..............####...........#######
##.............###########..##########..######.....#......#....###...................##...#........####........##..#.#......#..##...#....#...#.##....#....................................#....#######.......#####..#############..###...................#######
##............############..##########..##########............#####..................##.......................####.......##...####.............###............................................#########.............##############.......................#######
##########################..##########..###############...#.#.######################.#######################..#########..##########.#.#..#.#.#.############################################...#######################################################....#######
##########################..##########..###############...#.#.######################.#######################..#########..##########.#.#..#.#.#.############################################...#######################################################....#######
##########################..##########..###############...#.#.######################.#######################..#########..##########.#.#..#.#.#.############################################...#######################################################....#######
##########################..##########..###############...#.#.######################.#######################..#########..##########.#.#..#.#.#.############################################...#######################################################....#######
####.........................#########........................####............####...##.......................######.....#########...............#####......###########..##############...........................................###################....#######
###..##.##....................#########################........##......###.....##....##.#...#...........#.....#####......#########....#..#.#.#....####.......#######......############............................................###################....#######
##...##.##........................#####################.............#.#####.#..##....##...#...............#....###.......########...#..............###...#...######.......###########....................................................................#######
#.....................................#################...#....................##..#.##.#...#.....#..#..#.............................#..#.#.#......##..#.#..............................................................................................#######
##....##.##...........................#################.............#.#...#.#..##....##...#...............#....###............###...#....................#...######.......###########..#########################################################################
###...##.##...................####....#################........##..............##....##.#...#...........#.....####............####....#..#.#.#...............#######......############.#########################################################################
####.........................#####............................####............####...##.......................####............####..................##......###########..#######################################################################################
################################################################################################################################################################################################################################################################
################################################################################################################################################################################################################################################################
