type: mettagrid.map_builder.ascii.AsciiMapBuilder.Config
map_data: |-
  ####################
  #..................#
  #......#....#......#
  #......#....#......#
  #......#....#......#
  #......#....#......#
  #......#....#......#
  #......#....#......#
  #......#....#......#
  #......#....#......#
  #......#....#......#
  #......#....#......#
  #......#....#......#
  #......#....#......#
  #......#....#......#
  #......#....#......#
  #......#....#......#
  #......#....#......#
  #......#....#......#
  #......#....#......#
  #......#....#......#
  #......#....#......#
  #......#....#......#
  #......#....#......#
  #......#....#......#
  #.....=#..@.#......#
  ####################

char_to_map_name:
  "#": wall
  ".": empty
  "@": agent.agent
  "=": chest


