WWWWWWWWWWWWWWWWWWWWWWWWWWWWWWWW
W                              W
W                              W
W                              W
W                              W
W                              W
W            WWWWWW            W
W              a               W
W            WWWWWW            W
W                              W
W     A                        W
W               WWWWWW         W
W                 a            W
W               WWWWWW         W
W                              W
W                              W
W                              W
W                              W
W                              W
W                              W
W           W W                W
W           W W                W
W           W W                W
W           WaW                W
W           W W                W
W           W W                W
W                              W
W                              W
W                              W
W                              W
W                              W
WWWWWWWWWWWWWWWWWWWWWWWWWWWWWWWW