WWWWWWWWWWWWWWWWWWWWWWWWWWWWWWWW
W                              W
W                              W
W                              W
W                              W
W        WWWWWWWWWWWWWWWWWW    W
W                a             W
W        WWWWWWWWWWWWWWWWWW    W
W                              W
W     A                        W
W     WWWWWWWWWWWWWWWWWW       W
W             a                W
W     WWWWWWWWWWWWWWWWWW       W
W                              W
W                              W
W           W W                W
W           W W                W
W           W W                W
W           W W                W
W           W W                W
W           W W                W
W           W W                W
W           W W                W
W           WaW                W
W           W W                W
W           W W                W
W           W W                W
W           W W                W
W           W W                W
W           W W                W
W           W W                W
W           W W                W
W           W W                W
W                              W
W                              W
WWWWWWWWWWWWWWWWWWWWWWWWWWWWWWWW