WWWWWWWWWWWWWWWWWWWWWWWWWWWWWWWW
W                              W
W                              W
W                              W
W                              W
W         WWWWWWWWWWWWWWW      W
W                a             W
W         WWWWWWWWWWWWWWW      W
W                              W
W     A                        W
W      WWWWWWWWWWWWWWWW        W
W             a                W
W      WWWWWWWWWWWWWWWW        W
W                              W
W                              W
W           W W                W
W           W W                W
W           W W                W
W           W W                W
W           W W                W
W           W W                W
W           W W                W
W           WaW                W
W           W W                W
W           W W                W
W           W W                W
W           W W                W
W           W W                W
W           W W                W
W           W W                W
W                              W
W                              W
WWWWWWWWWWWWWWWWWWWWWWWWWWWWWWWW