WWWWWWWWWWWWWWWWWWWWWWWWWWWWWWWW
W                              W
W                              W
W                              W
W                              W
W                              W
W           WWWWWWWWW          W
W               a              W
W           WWWWWWWWW          W
W                              W
W     A                        W
W             WWWWWWWWW        W
W                 a            W
W             WWWWWWWWW        W
W                              W
W                              W
W                              W
W                              W
W           W W                W
W           W W                W
W           W W                W
W           W W                W
W           WaW                W
W           W W                W
W           W W                W
W           W W                W
W           W W                W
W                              W
W                              W
W                              W
W                              W
WWWWWWWWWWWWWWWWWWWWWWWWWWWWWWWW