WWWWWWWWWWWWWWWWWWWWWWWWWWWWWWWW
W                              W
W                              W
W                              W
W                              W
W                              W
W            WWWW              W
W              a               W
W            WWWW              W
W                              W
W     A                        W
W               WWWW           W
W                 a            W
W               WWWW           W
W                              W
W                              W
W                              W
W                              W
W                              W
W                              W
W                              W
W                              W
W           W  W               W
W           W aW               W
W           W  W               W
W           W  W               W
W                              W
W                              W
W                              W
W                              W
W                              W
WWWWWWWWWWWWWWWWWWWWWWWWWWWWWWWW