WWWWWWWWWWWWWWWWWWWWWWWWWWWWWWWW
W                              W
W                              W
W                              W
W                              W
W                              W
W          WWWWWWWWWWWWWW      W
W                a             W
W          WWWWWWWWWWWWWW      W
W                              W
W     A                        W
W       WWWWWWWWWWWWWW         W
W             a                W
W       WWWWWWWWWWWWWW         W
W                              W
W                              W
W           W W                W
W           W W                W
W           W W                W
W           W W                W
W           W W                W
W           W W                W
W           WaW                W
W           W W                W
W           W W                W
W           W W                W
W           W W                W
W           W W                W
W           W W                W
W           W W                W
W                              W
WWWWWWWWWWWWWWWWWWWWWWWWWWWWWWWW