WWWWWWWWWWWWWWWWWWWWWWWWWWWWWWWW
W                              W
W                              W
W                              W
W                              W
W                              W
W           WWWWWWWW           W
W              a               W
W           WWWWWWWW           W
W                              W
W     A                        W
W             WWWWWWWW         W
W                 a            W
W             WWWWWWWW         W
W                              W
W                              W
W                              W
W                              W
W           W W                W
W           W W                W
W           W W                W
W           W W                W
W           WaW                W
W           W W                W
W           W W                W
W           W W                W
W                              W
W                              W
W                              W
W                              W
W                              W
WWWWWWWWWWWWWWWWWWWWWWWWWWWWWWWW