WWWWWWWWWWWWWWWWWWWWWWWWWWWWWWWW
W                              W
W                              W
W                              W
W                              W
W                              W
W          WWWWWWWWWWWW        W
W               a              W
W          WWWWWWWWWWWW        W
W                              W
W     A                        W
W            WWWWWWWWWWWW      W
W                 a            W
W            WWWWWWWWWWWW      W
W                              W
W                              W
W           W W                W
W           W W                W
W           W W                W
W           W W                W
W           W W                W
W           W W                W
W           WaW                W
W           W W                W
W           W W                W
W           W W                W
W           W W                W
W           W W                W
W                              W
W                              W
W                              W
WWWWWWWWWWWWWWWWWWWWWWWWWWWWWWWW