WWWWWWWWWWWWWWWWWWWWWWWWWWWWWWWW
W                              W
W                              W
W                              W
W                              W
W                              W
W           WWWWWWW            W
W              a               W
W           WWWWWWW            W
W                              W
W     A                        W
W              WWWWWWW         W
W                 a            W
W              WWWWWWW         W
W                              W
W                              W
W                              W
W                              W
W                              W
W           W W                W
W           W W                W
W           W W                W
W           WaW                W
W           W W                W
W           W W                W
W           W W                W
W                              W
W                              W
W                              W
W                              W
W                              W
WWWWWWWWWWWWWWWWWWWWWWWWWWWWWWWW