WWWWWWWWWWWWWWWWWWWWWWWWWWWWWWWW
W                              W
W                              W
W                              W
W                              W
W        WWWWWWWWWWWWWWWW      W
W                a             W
W        WWWWWWWWWWWWWWWW      W
W                              W
W     A                        W
W     WWWWWWWWWWWWWWWWW        W
W             a                W
W     WWWWWWWWWWWWWWWWW        W
W                              W
W                              W
W           W W                W
W           W W                W
W           W W                W
W           W W                W
W           W W                W
W           W W                W
W           W W                W
W           WaW                W
W           W W                W
W           W W                W
W           W W                W
W           W W                W
W           W W                W
W           W W                W
W           W W                W
W           W W                W
W                              W
WWWWWWWWWWWWWWWWWWWWWWWWWWWWWWWW