################
#@......L......#
#_..s.#...m....#
#..#..s..#..L..#
#....s....#....#
#.#.....s...#..#
#....m...#...s.#
#..#.......#...#
#.......L......#
#..s..#....m...#
#.......#.....@#
#....#...L...s_#
################