################
#@......L......#
#a..s.#...m....#
#..#..s..#..L..#
#....s....#....#
#.#.....s...#..#
#....m...#...s.#
#..#.......#...#
#.......L......#
#..s..#....m...#
#.......#.....@#
#....#...L...sa#
################