##############
#...L..@.....#
#a..#..m.#...#
#...#......@.#
#.#..s.#..L..#
#........#...#
#..#...s...#.#
#...m...#....#
#..s..#......#
#.......#...a#
#.....L......#
##############