WWWWWWWWWWWW
W  W  L  A W
Wa   WWW m W
W  W   W   W
W  s W s W W
W  W   A   W
W m  WWW  aW
W  W   L   W
W    W   W W
W      W   W
WWWWWWWWWWWW
