############
#..#..L..@.#
#a...###.m.#
#..#...#...#
#..s.#.s.#.#
#..#...@...#
#.m..###..a#
#..#...L...#
#....#...#.#
#......#...#
############