WWWWWWWWWWWWWWWWWWWWWWWWWWWW
W                          W
W   A                      W
W             WWWWWW       W
W             W            W
W             W    m       W
W             W            W
W             W            W
W WWWW                     W
W    W                     W
W  g W                     W
W                          W
W                          W
W                          W
W                          W
W                          W
W                          W
W        WWWWW  WWW        W
W        W   a    W        W
W           W              W
W                          W
W                          W
WWWWWWWWWWWWWWWWWWWWWWWWWWWW
