#####################
########....#########
########....#########
########....#########
########....#########
########....#########
########....#########
########....#########
########....#########
#...................#
#._........@........#
#.................._#
#...................#
########....#########
########....#########
########....#########
########....#########
########....#########
########....#########
########....#########
########.._.#########
########....#########
#####################
