###########################################
#.........................................#
#.........##########......................#
#.........#...._...#......................#
#.........#........#...........@..........#
#.........#####....#......................#
#..................#......................#
#...........########......................#
#.........................................#
#..................#############..........#
#..................#...........#..........#
#..................#....#.._...#..........#
#.......................#......#..........#
#.......................#......#..........#
#.......................########..........#
#....#######..............................#
#....#...._#..............................#
#....#.....#..............................#
#....#.....#..............................#
#....#..####..............................#
#....#....................................#
#....#####................................#
#.........................................#
#.........................................#
###########################################