###################################
#.................................#
#.........##########..............#
#.........#....a...#..............#
#.........#........#...........@..#
#.........#........#..............#
#.........#######..#..............#
#.................................#
#.................................#
#.......................##.#####..#
#.......................#......#..#
#.......................#..a...#..#
#.......................#......#..#
#.......................#......#..#
#.......................########..#
#....#######......................#
#....#.a...#......................#
#....#.....#......................#
#....#.....#......................#
#....#.....#......................#
#....####..#......................#
#.................................#
#.................................#
#.................................#
###################################