WWWWWWWWWWWWWWWWWWWWWWWWWWWWWWWWWWWWWWWW
W WWWWW  A                             W
W     W     W     W     WW   WWW   W   W
W WWWW                           WWWWW W
W     W     W     W     W     W        W
W WWWW W        WWW W          WWWWW   W
W     W     W     W     W     W        W
W WWWWW WWWWW       WWWWW WW         WWW
W     W     W     W     W     W      a W
W WWWWWW W      WWWWWW WWWWWW WW  WWWWWW
W     W            W     W             W
W   W     W   W     W   W              W
W W WWW  a   WWW W W                   W
W W           W W W     W           W WW
W WWWWW    W WWW WWW W        WW WWWWW W
W     W     W     W   W             W  W
W WWW WWW      WWWWWW            WW WWWW
W   W   W     W         W   W   W     WW
W WWW WWWWWW    WWW WWWWWWW         WWWW
W   W     W     W   W     W            W
W                                      W
W     W     W     W   W     W     W    W
W WWWWW          WW WWWWW WW          WW
W     W     W     W     W     W     W  W
W WWWWWW WWWWWW WWWWWW                 W
W     W     W     W     W     W     W  W
W WWWW W        WWW W      a   WWW     W
W     W     W     W     W     W     W  W
WWWWWWWWWWWWWWWWWWWWWWWWWWWWWWWWWWWWWWWW