WWWWWWWWWWWWWWWWWWWWWWWWWWWWWWWWWWWWWWWW
W WWWWW  A                             W
W     W     W     W     WW   WWW   W   W
W WWWW                           WWWWW W
W     W     W     W     W     W        W
W WWWW W        WWW W          WWWWW   W
W     W           W     W     W        W
W WWWWWWWWWWW       WWWWW WW         WWW
W     W     W     W     W            a W
W WWWWWW W      WWWWWW WWWW       WWWWWW
W     W            W     W             W
W   W     W   W     W   W              W
W W WWW  a                             W
W W                     W           W WW
W WWWWW    W         W        WW WWWWW W
W     W     W     W   W             W  W
W WWW WWW      WWWWWW            WW WWWW
W   W   W     W         W   W   W     WW
W WWW WWWWWW    WWW WWW             WWWW
W   W     W     W   W                  W
W                                      W
W     W     W     W   W     W     W    W
WWWWWWW          WW WWWWW WW          WW
W     W     W     W     W     W     W  W
W WWWWWW WWWWWW WWWWWW                 W
W     W     W     W     W     W     W  W
W WWWW W        WWW W      a   WWW     W
W     W     W     W     W     W     W  W
WWWWWWWWWWWWWWWWWWWWWWWWWWWWWWWWWWWWWWWW