########################################
#.#####..@.............................#
#.....#.....#.....#.....##...###...#...#
#.####...........................#####.#
#.....#.....#.....#.....#.....#........#
#.####.#........###.#..........#####...#
#.....#.....#.....#.....#.....#........#
#.#####.#####.......#####.##.........###
#.....#.....#.....#.....#.....#......_.#
#.######.#......######.######.##..######
#.....#............#.....#.............#
#...#.....#...#.....#...#..............#
#.#.###.._...###.#.#...................#
#.#...........#.#.#.....#...........#.##
#.#####....#.###.###.#........##.#####.#
#.....#.....#.....#...#.............#..#
#.###.###......######............##.####
#...#...#.....#.........#...#...#.....##
#.###.######....###.#######.........####
#...#.....#.....#...#.....#............#
#......................................#
#.....#.....#.....#...#.....#.....#....#
#.#####..........##.#####.##..........##
#.....#.....#.....#.....#.....#.....#..#
#.######.######.######.................#
#.....#.....#.....#.....#.....#.....#..#
#.####.#........###.#......_...###.....#
#.....#.....#.....#.....#.....#.....#..#
########################################