WWWWWWWWWWWWWWWWWWWWWWWWWWWWWWWWWWWWWWWWWWWWWWWWWWWWWWWWWWWWWWWWWWWWWWWWWWWWWWWWWWWWWWWWWWWWWWWWWW
WWWWWWWWWWWWWW  WWWWWWWWWWWWWWWWWWWWWWWWWWWWWWWW  WWWWWWWWWWWWW  WWWWWWWWWWWWWWWWWWWWWWWWWWWWWWWWW
WWWWWWWWWWWWWW  WWa          WWWWW          WWWW  WWWWWWWWWWWWW  WWWW         aWWWWW           WWW
WWWWWWWWWWWWWW  WWa          WWWWW          WWWW  W   W A WaaaW  WWWW         aWWWWW           WWW
WWWWWWWWWWWWWW  WWa          WWWWW          WWWW  W   W   W   W  WWWW         aWWWWW           WWW
WW           W  WWWWWWWWWW   WWWWWWWWWWWW   WWWW  W   W   W   W  WWWW   WWWWWWWWWWWW   WWWWWWWWWWW
WW           W  WW           WWWWW          WWWW  W   W   W   W  WWWW          WWWWW           WWW
WW           W  WWA          WWWWWA         WWWW  W   W   W   W  WWWW         AWWWWW          AWWW
WW   W   W   W  WW           WWWWW          WWWW  W   W   W   W  WWWW          WWWWW           WWW
WW   W   W   W  WWWWWWWWWW   WWWWWWWWWWWW   WWWW  W   W   W   W  WWWW   WWWWWWWWWWWW   WWWWWWWWWWW
WW   W   W   W  WW           WWWWWa         WWWW  W   W   W   W  WWWW          WWWWW          aWWW
WW   W   W   W  WW           WWWWWa         WWWW  W           W  WWWW          WWWWW          aWWW
WW   W   W   W  WW           WWWWWa         WWWW  W           W  WWWW          WWWWW          aWWW
WW   W   W   W  WWWWWWWWWWWWWWWWWWWWWWWWWWWWWWWW  W           W  WWWWWWWWWWWWWWWWWWWWWWWWWWWWWWWWW
WW   W A WaaaW                                    WWWWWWWWWWWWW                                  W
WWWWWWWWWWWWWW                                    WWWWWWWWWWWWW                                  W
WWWWWWWWWWWWWW                                    WWWWWWWWWWWWW                                  W
WWWWWWWWWWWWWW                                    WWWWWWWWWWWWW                                  W
WWWWWWWWWWWWWW                                    WWWWWWWWWWWWW                                  W
WWWWWWWWWWWWWW                                    WWWWWWWWWWWWW                                  W
WW           W                                    W           W                                  W
WW           W                                    W           W                                  W
WW           W                                    W           W                                  W
WW   W   W   W                                    W   W   W   W                                  W
WW   W   W   W                                    W   W   W   W                                  W
WW   W   W   W                                    W   W   W   W                                  W
WW   W   W   W                                    W   W   W   W                                  W
WW   W   W   W                                    W   W   W   W                                  W
WW   W   W   W                                    W   W   W   W                                  W
WW   W   W   W                                    W   W   W   W                                  W
WWaaaW A W   W                                    WaaaW A W   W                                  W
WWWWWWWWWWWWWW                                    WWWWWWWWWWWWW                                  W
WWWWWWWWWWWWWW                                    WWWWWWWWWWWWW                                  W
WWWWWWWWWWWWWWWWWWWWWWWWWWWWWWWWWWWWWWWWWWWWWWWWWWWWWWWWWWWWWWWWWWWWWWWWWWWWWWWWWWWWWWWWWWWWWWWWWW