WWWWWWWWWWWWWWWWWWWW
W                  W
W                  W
W        a         W
W                  W
W                  W
W                  W
WWWW            WWWW
W                  W
W      W    W      W
W      W    W      W
W      W    W      W
W      W    W      W
W      W    W      W
W      W    W      W
W      W    W      W
W      W    W      W
W      W    W      W
W      W    W      W
W      W    W      W
W      W    W      W
W  a   W  A W  a   W
WWWWWWWWWWWWWWWWWWWW