WWWWWWWWWWWWW
WWWWWWWWWWWWW
WWWWWWWWWWWWW
WWWWWWWWWWWWW
W           W
W           W
W           W
W   W   W   W
W   W   W   W
W   W   W   W
W   W   W   W
W   W   W   W
W   W   W   W
W   W   W   W
W   W   W   W
W   W   W   W
W   W   W   W
W   W   W   W
W   W   W   W
W   W   W   W
W   W   W   W
W   W   W   W
W   W   W   W
W   W   W   W
W   W   W   W
W   W   W   W
W   W   W   W
W   W   W   W
W   W A WaaaW
WWWWWWWWWWWWW
WWWWWWWWWWWWW
WWWWWWWWWWWWW
WWWWWWWWWWWWW
WWWWWWWWWWWWW
W           W
W           W
W           W
W   W   W   W
W   W   W   W
W   W   W   W
W   W   W   W
W   W   W   W
W   W   W   W
W   W   W   W
W   W   W   W
W   W   W   W
W   W   W   W
W   W   W   W
W   W   W   W
W   W   W   W
W   W   W   W
W   W   W   W
W   W   W   W
W   W   W   W
W   W   W   W
W   W   W   W
W   W   W   W
W   W   W   W
WaaaW A W   W
WWWWWWWWWWWWW
WWWWWWWWWWWWW