
#########################
#.......................#
#.......................#
#.......................#
#...#....#....#....#....#
#...#....#....#....#....#
#...#....#....#....#....#
#...#....#....#....#....#
#...#....#....#....#....#
#...#....#....#....#....#
#...#....#....#....#....#
#...#.._..#..@.#...#....#
#########################
#########################
#########################
#########################
#########################
#########################
#########################
#.......................#
#.......................#
#.......................#
#...#....#....#....#....#
#...#....#....#....#....#
#...#....#....#....#....#
#...#....#....#....#....#
#...#....#....#....#....#
#...#....#....#....#....#
#...#....#....#....#....#
#...#....#..@.#._..#....#
#########################
#########################
#########################
#########################