############################
#..........................#
#...@......................#
#.............######.......#
#.............#............#
#.............#...._.......#
#.............#............#
#.............#............#
#.####.....................#
#....#.....................#
#.._.#.....................#
#..........................#
#..........................#
#..........................#
#..........................#
#..........................#
#..........................#
#........#####..###........#
#........#..._....#........#
#...........#..............#
#..........................#
#..........................#
############################