WWWWWWWWWWWWWWWWWWWWWWWWWW
WA              W        W
W               WWWWWWWWWW
W   WWWWWWW              W
W   WWWWWWWW             W
W   W     aW             W
W   W      W             W
W   W     WW             W
W   W           W        W
W   W           W        W
W               W        W
W   WWWWWW      W        W
W             WWW        W
W                      W W
W   WWWWW    WWWWWW    W W
W               W      W W
W              W       W W
W              Wa  WWW W W
W              WWWW      W
W                        W
W                        W
W            WWWWWWWWWWWWW
W                 a      W
W    W                   W
WWWWWWWWWWWWWWWWWWWWWWWWWW