######################
a...#####...###....a.#
##.....###..##....####
####....##..#....#####
#####..........#######
#........@...........#
#######........#######
#####....#..#.....####
###.....##..####....##
#....#####..######.a##
######################