WWWWWWWWWWWWWWWWWWWWWWWWWWWWWWWWWWWWWWWWWWWWWWWWWWWWWWWWWWWWWWWWWWWWWWWWWWWWWWWWWWWWWWWW
WWW           WWWWWWWWWWWWWWWWWWWWWWWW       WWWWWWWWWWWWWWWWWWWWWWWWWWWWWWWWWWWWWWWWWWW
WWWWWW            WWWWWWWWWWWWWWWWWWWW  a    WWWWWWWWWWWWWWWWWWWWWWWWWWWWWWWWWWWWWWWWWWW
WWWWWW            WWWWWWWWWWWWWWWWWWW        WWWWWWWWWWWWWWWWWWWWWWWWWWWWWWWWWWWWWWWWWWW
WWWWWWWWW            WWWWWWWWWWWWWWWWW       WWWWWWWWWWWWWWWWWWWWWWW           WWWWWWWWW
WWWWWWWWWWW           WWWWWWWWWWWWWWWW       WWWWWWWWWWWWWWWWWWWW             WWWWWWWWWW
WWWWWWWWWWWW           WWWWWWWWWWWWWWW       WWWWWWWWWWWWWWWW              WWWWWWWWWWWWW
WWWWWWWWWWWWW            WWWWWWWWWWWW       WWWWWWWWWWWWW              WWWWWWWWWWWWWWWWW
WWWWWWWWWWWWWWWW           WWWWWWWWWWW       WWWWWWWWWWW           WWWWWWWWWWWWWWWWWWWWW
WWWWWWWWWWWWWWWWWW           WWWWWWWWW       WWWWWWWWW           WWWWWWWWWWWWWWWWWWWWWWW
WWWWWWWWWWWWWWWWWWWW           WWWWWWW       WWWWWWW           WWWWWWWWWWWWWWWWWWWWWWWWW
WWWWWWWWWWWWWWWWWWWWWW           WWWWW       WWWWWW         WWWWWWWWWWWWWWWWWWWWWWWWWWWW
WWWWWWWWWWWWWWWWWWWWWWWW          WWWW       WWWW        WWWWWWWWWWWWWWWWWWWWWWWWWWWWWWW
WWWWWWWWWWWWWWWWWWWWWWWWWW          WW       WW         WWWWWWWWWWWWWWWWWWWWWWWWWWWWWWWW
WWWWWWWWWWWWWWWWWWWWWWWWWWWWW                           WWWWWWWWWWWWWWWWWWWWWWWWWWWWWWWW
W                                                                                      W
W                                     A                                                W
W                                                                                      W
W                                                                                      W
WWWWWWWWWWWWWWWWWWWWWWWWWWWW                         WWWWWWWWWWWWWWWWWWWWWWWWWWWWWWWWWWW
WWWWWWWWWWWWWWWWWWWWWWWWWW                              WWWWWWWWWWWWWWWWWWWWWWWWWWWWWWWW
WWWWWWWWWWWWWWWWWWWWWWWW          WWWW       WWW        WWWWWWWWWWWWWWWWWWWWWWWWWWWWWWWW
WWWWWWWWWWWWWWWWWWWWW           WWWWWW       WWWW           WWWWWWWWWWWWWWWWWWWWWWWWWWWW
WWWWWWWWWWWWWWWWWWWWW           WWWWWWW       WWWWWW         WWWWWWWWWWWWWWWWWWWWWWWWWWW
WWWWWWWWWWWWWWWWWWWW         WWWWWWWWW       WWWWWWWW           WWWWWWWWWWWWWWWWWWWWWWWW
WWWWWWWWWWWWWWWWWW         WWWWWWWWWW        WWWWWWWWWWW           WWWWWWWWWWWWWWWWWWWWW
WWWWWWWWWWWWWWWW         WWWWWWWWWWWWW       WWWWWWWWWWWWWW          WWWWWWWWWWWWWWWWWWW
WWWWWWWWWWWWWW         WWWWWWWWWWWWWWW       WWWWWWWWWWWWWWWWW           WWWWWWWWWWWWWWW
WWWWWWWWWWW     a     WWWWWWWWWWWWWWWWW       WWWWWWWWWWWWWWWWWWW           WWWWWWWWWWWW
WWWWWW              WWWWWWWWWWWWWWWWWW       WWWWWWWWWWWWWWWWWWWWWW    a     WWWWWWWWWWW
WWWWWWWWWWWWWWWWWWWWWWWWWWWWWWWWWWWWWWWWWWWWWWWWWWWWWWWWWWWWWWWWWWWWWWWWWWWWWWWWWWWWWWWW