🧱🧱🧱🧱🧱🧱🧱🧱🧱🧱🧱🧱🧱🧱🧱🧱🧱🧱🧱🧱🧱🧱
⛩   🧱🧱🧱🧱🧱   🧱🧱🧱    ⛩ 🧱
🧱🧱     🧱🧱🧱  🧱🧱    🧱🧱🧱🧱
🧱🧱🧱🧱    🧱🧱  🧱    🧱🧱🧱🧱🧱
🧱🧱🧱🧱🧱          🧱🧱🧱🧱🧱🧱🧱
🧱        A           🧱
🧱🧱🧱🧱🧱🧱🧱        🧱🧱🧱🧱🧱🧱🧱
🧱🧱🧱🧱🧱    🧱  🧱     🧱🧱🧱🧱
🧱🧱🧱     🧱🧱  🧱🧱🧱🧱    🧱🧱
🧱    🧱🧱🧱🧱🧱  🧱🧱🧱🧱🧱🧱 ⛩🧱🧱
🧱🧱🧱🧱🧱🧱🧱🧱🧱🧱🧱🧱🧱🧱🧱🧱🧱🧱🧱🧱🧱🧱
