###########################################
#.........................................#
#.........##########......................#
#.........#....a...#......................#
#.........#........#...........@..........#
#.........#####....#......................#
#..................#......................#
#...........########......................#
#.........................................#
#..................#############..........#
#..................#...........#..........#
#..................#....#..a...#..........#
#.......................#......#..........#
#.......................#......#..........#
#.......................########..........#
#....#######..............................#
#....#....a#..............................#
#....#.....#..............................#
#....#.....#..............................#
#....#..####..............................#
#....#....................................#
#....#####................................#
#.........................................#
#.........................................#
###########################################