WWWWWWWWWWWWWWWWWWWWWWWWWWWWWWWWWWWWWWWWWWWWWWWWWWWWWWWWWWWWWWWWWWWWWWW
W      W      W      W      W      W      W      W      W      W      W
W      W      W             W      W      W      W      W      W      W
W  A                        W      W      W      W      W      W      W
W                    W      W      W      W      W      W      W      W
W      W      W      W      W      W      W      W      W      W      W
WWW  WWWWWWWWWWWWWWWWWWW   WWWWWWWWWWWWWWWWWWWWWWWWWWWWWWWWWWWWWWWWWWWW
W      W             W      W             W      W      W             W
W      W             W      W             W      W                    W
W             W      W             W  a   W                           W
W             W                    W      W             W             W
W      W      W      W      W      W             W      W             W
WWWWW  WWW WWWWW  WWWWWWW  WWWW WWWWWWWW WWWW WWWWWWWW WWW          a W
W      W      W      W      W      W             W      W             W
W             W             W      W             W                    W
W             W      W  a                 W      W                    W
W      W             W      W             W             W             W
W      W             W      W      W      W             W             W
WWWWWWWWWWWWWWWWWWWWWWWWWWWWWWWWWWWWWWWWWWWWWWWWWWWWWWWWWWWWWWWWWWWWWWW