WWWWWWWWWWWWWWWWWWWWWWWWWWWWWW
W A                          W
WWWWWWWWWWWWWWWW             W
W                            W
W                            W
W                            W
W         WWWWWWWWWWWWWWWWWWWW
W                            W
W                            W
W                            W
WWWWWWWWWWWWWWWWWWW          W
W                            W
W                            W
W                            W
W    a     WWWWWWWWWWWWWWWWWWW
W                            W
W                            W
W                            W
WWWWWWWWWWWWWW               W
W                            W
W                            W
W                            W
W           WWWWWWWWWWWWWWWWWW
W    a                       W
W                            W
W                            W
WWWWWWWWWWWWWWWWW            W
W                            W
W                            W
W                            W
W        WWWWWWWWWWWWWWWWWWWWW
W                            W
W                     a      W
W                            W
WWWWWWWWWWWWWWWWWWWWWWWWWWWWWW