################################
#............m.................#
#..............................#
#...########################...#
#...#......................#...#
#...#...######....######...#...#
#...#...#..............#...#..n#
#...#...#..#########...#...#...#
#...#...#..#..@....#...#...#...#
#...#...#..#.......#...#.......#
#...#...#..#...........#.......#
#...#...#..#...........#...#...#
#...#...#..#########...#...#.._#
################################
