##################################
#...........#....................#
#...#...#...#....................#
#####...#...#....................#
#...#...#...#....................#
#.n.#...#.n.#....................#
#####...##########################
#......................@.........#
#................................#
#####...##############...#########
#._.#...#._.#.....#.m.#...#.m.#..#
#...#...#...#.....#...#...#...#..#
#####...#...#.....#####...#...#..#
#...#...#...#.....#...#...#...#..#
#...........#.....#...........#..#
#...........#.....#...........#..#
##################################
