##############
##############
##############
##############
##############
##...........#
##.....m.....#
##...........#
##...#...#...#
##...#...#...#
##...#...#...#
##...#...#...#
##...#...#...#
##.n.#.@.#_..#
##############
##############
