#############################
#....#...#...#....#.@._#..n.#
#....#...#...#....#....#....#
#....#...#...#....#....#....#
#....#...#...#....#....#....#
#....#...#...#....#....#....#
##########...#....#...##....#
#...........................#
#...........................#
#...........................#
#...........................#
#...........................#
#...........................#
#.......m...................#
#...........................#
#...........................#
#...........................#
#############################
