#############
#############
#############
#############
#...........#
#...........#
#...........#
#...#...#...#
#...#...#...#
#...#...#...#
#...#...#...#
#...#...#...#
#...#...#...#
#...#...#...#
#...#...#...#
#...#...#...#
#...#...#...#
#...#...#...#
#...#...#...#
#...#...#...#
#..a#n..#m@.#
#############
#############
