############################
#..........................#
#...@._....................#
###############............#
#..m..................._...#
#..........................#
###############............#
#...n.........#............#
#.......####...............#
#.............#............#
#.............#............#
#.............#............#
#..........................#
#..........................#
#..........................#
#..........................#
#..........................#
#..........................#
#..........................#
#..........................#
#.............#............#
#.............#............#
#########..........#########
#..........................#
#..........................#
############################
