############################
#.....................#@...#
#.....................#....#
#.....................#....#
#.....................#....#
#.....................#....#
#.....................#....#
#..........................#
#..........................#
#.....................#_...#
#.....................#....#
#.....................#....#
#.....................#....#
#.....................#....#
#.....................######
#......#n..................#
#......#...................#
#......#####################
#..........................#
#..........................#
#..........................#
#..........................#
######.............#########
#.......m..................#
############################
