###################################################
#...............................................@.#
#.................................................#
#.....#############################################
#.....#m..........................................#
#.....#...........................................#
#.....#...........................................#
#.....#####################################....._.#
#.................................................#
#...........................n.....................#
####################################################
