###########
#.......#m#
#.#....#..#
#.#....#..#
#.#._..#..#
#.#..@.#..#
#.#....#..#
#.#....#..#
#n#.......#
###########
