WWWWWWWWWWWWWWWWWWWWWWWWWWWWWWWWWWWWWWWWWWWWWWWWWWWWWWWWWWWWWWWWWWWWWWWWWWWWWWWWWWWWWWWWWWWWWWWWWWWWWWWWWWWWWWWWWWWWWWWWWWWWWWWWWWW
W     W   W     W     W     W    W     W     W     W    W a A W     W     W   W     W     W     W    W     W     W     W    W     W
W     W   W     W     W     W    W     W     W     W    W     W     W     W   W     W     W     W    W     W     W     W    W     W
W     W   W     W     W     W    W     W     W     W    W     W     W     W   W     W     W     W    W     W     W     W    W     W
W     W   W     W     W     W    W     W     W     W    W     W     W     W   W     W     W     W    W     W     W     W    W     W
W     W   W     W     W     W    W     W     W     W    W     W     W     W   W     W     W     W    W     W     W     W    W     W
W     W   W     W     W     W    W     W     W     W    W     W     W     W   W     W     W     W    W     W     W     W    W     W
W     W   W     W     W     W    W     W     W     W    W     W     W     W   W     W     W     W    W     W     W     W    W     W
W     W   W     W     W     W    W     W     W     W    W     W     W     W   W     W     W     W    W     W     W     W    W     W
W     W   W     W     W     W    W     W     W     W    W     W     W     W   W     W     W     W    W     W     W     W    W     W
W     W   W     W     W     W    W     W     W     W    W    LW     W     W   W     W     W     W    W     W     W     W    W     W
WL    WWWWW     WWWWWWW     WWWWWW     WWWWWWW     WWWWWW     WWWWWWW     WWWWW     WWWWWWW     WWWWWW     WWWWWWW     WWWWWW     W
W                                                                                                                                 W
W                                                                                                                                 W
W                                                                                                                                 W
W                                                                                                                                 W
W                                                                                                                                 W
W                                                                                                                                 W
W                                   g                                             m                                               W
W                                                                                                                                 W
W                                                                                                                                 W
W                                                                                                                                 W
W                                                                                                                                 W
WWWWWWWWWWWWWWWWWWWWWWWWWWWWWWWWWWWWWWWWWWWWWWWWWWWWWWWWWWWWWWWWWWWWWWWWWWWWWWWWWWWWWWWWWWWWWWWWWWWWWWWWWWWWWWWWWWWWWWWWWWWWWWWWWWW