WWWWWWWWWWWWWWWWWWWWWWWWWWWW
W                          W
W   A                      W
W                          W
W                  a       W
W                          W
W          R               W
W                          W
W                 r        W
W                          W
W                          W
W                          W
W                          W
W                          W
WWWWWWWWWWWWWWWWWWWWWWWWWWWW