WWWWWWWWWWWWWWWWWWWWWWWWWWWW
W                          W
W   A                      W
W                          W
W                  a       W
W                          W
W          G               W
W                          W
W                 g        W
W         B                W
W                          W
W      r          b        W
W                          W
W                          W
WWWWWWWWWWWWWWWWWWWWWWWWWWWW