#######################################################################
L.@...L#......#......#......#......#......#......#......#......#......#
#......#......#......#......#......#......#......#......#......#......#
#......#..m...#..n...#.._...#......#......#......#......#..m...#..n...#
#L.....#......#......#......#......#......#......#......#......#......#
#......#......#......#......#......#......#......#......#......#......#
#######################################################################
#......#......#......#......#......#......#......#......#......#......#
#......#......#......#......#......#......#......#......#......#......#
#......#......#......#......#..m...#..n...#.._...#......#......#.._...#
#......#......#......#......#......#......#......#......#......#......#
#......#......#......#......#......#......#......#......#......#......#
#######################################################################