WWWWWWWWWWWWWWWWWWWWWWWWWWWWWWWWWWWWWWWWWWWWWWWWWWWWWWWWWWWWWWWWWWWWWWW
L A   LW      W      W      W      W      W      W      W      W      W
W      W      W      W      W      W      W      W      W      W      W
W      W  m   W  n   W  a   W      W      W      W      W  m   W  n   W
WL     W      W      W      W      W      W      W      W      W      W
W      W      W      W      W      W      W      W      W      W      W
WWWWWWWWWWWWWWWWWWWWWWWWWWWWWWWWWWWWWWWWWWWWWWWWWWWWWWWWWWWWWWWWWWWWWWW
W      W      W      W      W      W      W      W      W      W      W
W      W      W      W      W      W      W      W      W      W      W
W      W      W      W      W  m   W  n   W  a   W      W      W  a   W
W      W      W      W      W      W      W      W      W      W      W
W      W      W      W      W      W      W      W      W      W      W
WWWWWWWWWWWWWWWWWWWWWWWWWWWWWWWWWWWWWWWWWWWWWWWWWWWWWWWWWWWWWWWWWWWWWWW