#######################################################################
L.@...L#......#......#......#......#......#......#......#......#......#
#......#......#......#......#......#......#......#......#......#......#
#......#..m...#..n...#..a...#......#......#......#......#..m...#..n...#
#L.....#......#......#......#......#......#......#......#......#......#
#......#......#......#......#......#......#......#......#......#......#
#######################################################################
#......#......#......#......#......#......#......#......#......#......#
#......#......#......#......#......#......#......#......#......#......#
#......#......#......#......#..m...#..n...#..a...#......#......#..a...#
#......#......#......#......#......#......#......#......#......#......#
#......#......#......#......#......#......#......#......#......#......#
#######################################################################