#########################################################################################
#.@....bbb......bbb......bbb......bbb......bbb......bbb......bbb......bbb......bbb......#
#......bbb......bbb......bbb......bbb......bbb......bbb......bbb......bbb......bbb......#
#..m...bbb..m...bbb..m...bbb..m...bbb..m...bbb..m...bbb..m...bbb..m...bbb..m...bbb..m...#
#......bbb......bbb......bbb......bbb......bbb......bbb......bbb......bbb......bbb......#
#......bbb......bbb......bbb......bbb......bbb......bbb......bbb......bbb......bbb......#
#bbbbbbbbbbbbbbbbbbbbbbbbbbbbbbbbbbbbbbbbbbbbbbbbbbbbbbbbbbbbbbbbbbbbbbbbbbbbbbbbbbbbbbb#
#bbbbbbbbbbbbbbbbbbbbbbbbbbbbbbbbbbbbbbbbbbbbbbbbbbbbbbbbbbbbbbbbbbbbbbbbbbbbbbbbbbbbbbb#
#bbbbbbbbbbbbbbbbbbbbbbbbbbbbbbbbbbbbbbbbbbbbbbbbbbbbbbbbbbbbbbbbbbbbbbbbbbbbbbbbbbbbbbb#
#......bbb......bbb......bbb......bbb......bbb......bbb......bbb......bbb......bbb......#
#......bbb......bbb......bbb......bbb......bbb......bbb......bbb......bbb......bbb......#
#..m...bbb..m...bbb..m...bbb..m...bbb..m...bbb..m...bbb..m...bbb..m...bbb..m...bbb..m...#
#......bbb......bbb......bbb......bbb......bbb......bbb......bbb......bbb......bbb......#
#......bbb......bbb......bbb......bbb......bbb......bbb......bbb......bbb......bbb......#
#bbbbbbbbbbbbbbbbbbbbbbbbbbbbbbbbbbbbbbbbbbbbbbbbbbbbbbbbbbbbbbbbbbbbbbbbbbbbbbbbbbbbbbb#