WWWWWWWWWWWWWWWWWWWWWWWWWWWWWWWWWWWWWWWW
W                                      W
W  A                                   W
W              b                       W
W             bmb                      W
W              b                       W
W      b                               W
W     bnb                              W
W      b            b                  W
W                  bab                 W
W                   b                  W
W                                      W
W                                      W
WWWWWWWWWWWWWWWWWWWWWWWWWWWWWWWWWWWWWWWW