########################################
#......................................#
#......................................#
#.................bbbbb................#
#.................bbmbb................#
#.................bbbbb...........bbgbb#
#.................................bbnbb#
#.................................bbgbb#
#.........@...............bbbbb........#
#.........................bb_bb........#
#.........................bbbbb........#
#......................................#
#......................................#
#......................................#
#......................................#
#......................................#
#......................................#
########################################