########################################
#......................................#
#..@...................................#
#..............b.......................#
#.............bmb......................#
#..............b.......................#
#......b...............................#
#.....bnb..............................#
#......b............b..................#
#..................b_b.................#
#...................b..................#
#......................................#
#......................................#
########################################