#######################################################################
#.@...........b......b......b......b......b......b......b......b......#
#.............b......b......b......b......b......b......b......b......#
#.............b..m...b..n...b..a...b......b......b......b......b......#
#.............b......b......b......b......b......b......b......b......#
#.............b......b......b......b......b......b......b......b......#
#bbbbbbbbbbbbbbbbbbbbbbbbbbbbbbbbbbbbbbbbbbbbbbbbbbbbbbbbbbbbbbbbbbbbb#
#......b......b......b......b......b......b......b......b......b......#
#......b......b......b......b......b......b......b......b......b......#
#......b..m...b..n...b..a...b......b......b......b..m...b..n...b..a...#
#......b......b......b......b......b......b......b......b......b......#
#......b......b......b......b......b......b......b......b......b......#
#######################################################################