map_data: |-
  ####################
  #..................#
  #..................#
  #..................#
  #........@.........#
  #..................#
  #...........sss....#
  #...........s_s....#
  #...........sss....#
  #..................#
  #..................#
  ####################
char_to_name_map:
  "#": wall
  ".": empty
  "@": agent.agent
  "s": silicon_ex_dep
  "_": altar
