type: mettagrid.map_builder.ascii.AsciiMapBuilder.Config
map_data: |-
  #####################
  #...................#
  #...................#
  #...................#
  #...................#
  #....###.@....##....#
  #......@...@........#
  #.......C@....O.....#
  #....@.....&.@......#
  #........@..........#
  #....#.....=...#....#
  #....###......##....#
  #...................#
  #...................#
  #####################
char_to_name_map:
  "#": wall
  ".": empty
  "C": carbon_extractor
  "O": oxygen_extractor
  "+": charger
  "&": assembler
  "=": chest
  "@": agent.agent

