type: mettagrid.map_builder.ascii.AsciiMapBuilder.Config
map_data: |-
  ##############################
  #...........#.@.#............#
  #.C...@...S.#...#.C....@...G.#
  #...........#...#............#
  #...........#...#............#
  #.G.........#...#............#
  #...............+............#
  #...............+............#
  #...............+............#
  #...........#...#............#
  #...........#...#............#
  #.O.........#...#.O........S.#
  #...........#...#............#
  #####++++#####...#####....####
  #............................#
  #@..........................@#
  #............................#
  #####++++####...##...#########
  #..........##...#..........G.#
  #..S......G.#...#............#
  #...........#...+............#
  #...............+............#
  #...............+...........S#
  #...............#............#
  #.....&.....#...#.....@......#
  #...........#...#............#
  #...........#...#............#
  #.O.........#...#.O........C.#
  #.........C.#.@.#............#
  ##############################
char_to_name_map:
  "#": wall
  ".": empty
  "C": carbon_extractor
  "S": silicon_extractor
  "O": oxygen_extractor
  "G": germanium_extractor
  "+": charger
  "&": assembler
  "@": agent.agent
