type: mettagrid.map_builder.ascii.AsciiMapBuilder.Config
map_data: |-
  #########################
  #....#..++.....#........#
  #@S.S#........#..OOOOO..#
  #....#.........#........#
  S....#.........#........#
  #......#....=..#........#
  #S.....#.......#....O...#
  #S.....#.......#........#
  #......#.......##.##....#
  #......#.......##++#....#
  ###....#......@.........#
  ##########..&...........#
  #......##......++#......#
  #......##.....#.........#
  #.G@.#.#......#.........#
  #......#......#.........#
  ?......#.....##.........#
  #GG...##......#.........#
  #......#......#....@....#
  #.............#.........#
  #..+++.........#........#
  #.............#.........#
  #.............#.........#
  #.............#.CCCCCCC.#
  #########################

char_to_name_map:
  "#": wall
  ".": empty
  "C": carbon_extractor
  "S": silicon_extractor
  "O": oxygen_extractor
  "G": germanium_extractor
  "+": charger
  "&": assembler
  "=": chest
  "@": agent.agent
  "1": agent.agent
  "2": agent.agent
  "3": agent.agent
  "4": agent.agent
  "?": empty
