type: mettagrid.map_builder.ascii.AsciiMapBuilder.Config
map_data: |-
  #######################
  #GGGGGGGGGG...........#
  #.....................#
  #####################.#
  #............CCCCC..#.#
  #.1234..............#.#
  #...................#.#
  #.....&.............#.#
  #...........SSSSS...#.#
  #...................#.#
  #...................#.#
  #.OOOO..............#.#
  #...................#.#
  #..................##.#
  #..................##.#
  #.........=.........#.#
  #...................#.#
  #...................#.#
  #...................#.#
  #.....................#
  #.....................#
  #.....................#
  #.....................#
  #######################
char_to_name_map:
  "#": wall
  ".": empty
  "G": germanium_extractor
  "C": carbon_extractor
  "S": silicon_extractor
  "O": oxygen_extractor
  "&": assembler
  "=": chest
  "1": agent.agent
  "2": agent.agent
  "3": agent.agent
  "4": agent.agent
