type: mettagrid.map_builder.ascii.AsciiMapBuilder.Config
map_data: |-
  #############################
  #...........##.##...........#
  #..C........##.##........O..#
  #...........##.##...........#
  #...........##.##...........#
  #...........##.##...........#
  #...........#@.@#...........#
  ##############@##############
  #############.+.#############
  #...........@.&.@...........#
  #############.=.#############
  ##############@##############
  #...........#@.@#...........#
  #...........##.##...........#
  #...........##.##...........#
  #...........##.##...........#
  #..G........##.##........S..#
  #...........##.##...........#
  #############################
char_to_name_map:
  "#": wall
  ".": empty
  "C": carbon_extractor
  "O": oxygen_extractor
  "G": germanium_extractor
  "S": silicon_extractor
  "+": charger
  "&": assembler
  "=": chest
  "@": agent.agent

