type: mettagrid.map_builder.ascii.AsciiMapBuilder.Config
map_data: |-
    ########################################
    #......................................#
    #....C.........................O.......#
    #......................................#
    #......................................#
    #......................................#
    #......................................#
    #......................................#
    #......................................#
    #......................................#
    #......................................#
    #......................................#
    #......................................#
    #......................................#
    #...........1...2..+...................#
    #......................................#
    #.................&.=..................#
    #......................................#
    #...........3.....@.....4..............#
    #......................................#
    #......................................#
    #......................................#
    #......................................#
    #....G.........................S.......#
    #......................................#
    #......................................#
    #......................................#
    #......................................#
    #......................................#
    #......................................#
    #......................................#
    ########################################
char_to_name_map:
  "#": wall
  ".": empty
  "O": oxygen_extractor
  "G": germanium_extractor
  "+": charger
  "C": carbon_extractor
  "S": silicon_extractor
  "@": agent.agent
  "&": assembler
  "=": chest
  "1": chest_carbon
  "2": chest_oxygen
  "3": chest_germanium
  "4": chest_silicon
