type: mettagrid.map_builder.ascii.AsciiMapBuilder.Config
map_data: |-
    ########################################
    #.........S........................#...#
    #.#.......................#............#
    #.#.........................#....#...#.#
    #..#.........####...................#..#
    #..#...#.....######...S......#.........#
    #......#...######.#.......#............#
    #......#...######.##.............##....#
    #....###......####........#....#....#..#
    #............#......................#..#
    #.#####................................#
    #..........S.............+...G#...#....#
    #.....####.............................#
    #...S....#........................S....#
    #........#.....###.....###.............#
    #........#.....#.........#.............#
    #.....#........#....=....#......#......#
    #.....#.........................##.....#
    #.....#...O.........&............##....#
    #.....#.............@.............#....#
    #.....#................................#
    #.....#.............+..................#
    #..........#...#.........#.......+.....#
    #..........#...#.........#.......S.....#
    #..........#...###.....###.............#
    #......#...#..........O......#.........#
    #.....#....#...............+..##.......#
    #.......+..#...................##......#
    #..............#####............##.....#
    #.......C......#...#......##.....##....#
    #..............#...#.....#.##......#...#
    #....######....#...#....##..##....##...#
    #.........###..#...#....#..O.###.##....#
    #..............#...#....##.....###.....#
    #..............#.........##............#
    #.........................###.....+....#
    #..C........................##.........#
    #....................C.................#
    #......................................#
    ########################################
char_to_name_map:
  "#": wall
  ".": empty
  "O": oxygen_extractor
  "G": germanium_extractor
  "+": charger
  "C": carbon_extractor
  "S": silicon_extractor
  "@": agent.agent
  "&": assembler
  "=": chest
