type: mettagrid.map_builder.ascii.AsciiMapBuilder.Config
map_data: |-
    ########################################
    #..................................#...#
    #.#........G..............#.........S..#
    #.#..O......................#....#...#.#
    #..#.........####...................#..#
    #..#...#.....######..........#....O....#
    #......#...######.#.......#............#
    #......#...######.##.............##....#
    #....###......####........#....#....#..#
    #............#......................#..#
    #.#####..................C.............#
    #............S................#...#....#
    #.....####.............................#
    #........#.............................#
    #........#.....###.....###........O....#
    #........#.....#O.......G#.............#
    #.....#........#....=....#......#......#
    #.....#.........................##.....#
    #.....#.............&............##....#
    #.....#.............@@@@@@@@......#....#
    #.....#................................#
    #.....#.............+..................#
    #..........#...#C.......S#.............#
    #..........#...#.........#.............#
    #..........#...###.....###........S....#
    #.....#....#.................#.........#
    #.....#....#..................##.......#
    #..O.......#.........G.........##......#
    #........S.....#####............##.....#
    #..............#...#......##.....##....#
    #..............#...#.....#.##......#...#
    #....######....#...#....##..##....##...#
    #.........###..#...#....#....###.##....#
    #..............#...#....##.....###.....#
    #..............#.........##............#
    #.........................###......C...#
    #...G..............C........##.........#
    #......................................#
    #......................................#
    ########################################
char_to_name_map:
  "#": wall
  ".": empty
  "O": oxygen_extractor
  "G": germanium_extractor
  "+": charger
  "C": carbon_extractor
  "S": silicon_extractor
  "@": agent.agent
  "&": assembler
  "=": chest


