type: mettagrid.map_builder.ascii.AsciiMapBuilder.Config
map_data: |-
    ########################################
    #.........O........................#..G#
    #.#..O....................#............#
    #.#.........................#....#...#.#
    #..#.........####.........G......G..#..#
    #..#...#.....######..........#.........#
    #.O....#...######.#.......#.........G..#
    #......#...######.##.............##....#
    #....###......####........#....#....#..#
    #............#......................#..#
    #.#####................................#
    #........................+...G#...#....#
    #.....####.............................#
    #........#.............................#
    #........#.....###.....###.............#
    #........#.....#.........#.............#
    #.....#........#....=....#......#......#
    #.....#.........................##.....#
    #.....#.............&............##....#
    #.....#.............@@@@@@@@......#....#
    #.....#................................#
    #.....#.............+..................#
    #..........#...#.........#.......+.....#
    #..........#...#.........#.............#
    #..........#...###.....###.............#
    #.....#C...#.................#.........#
    #.....#....#...............+..##.......#
    #.......+..#...................##......#
    #..............#####............##.....#
    #..............#...#......##.....##....#
    #..............#...#.....#.##......#...#
    #....######....#...#....##..##....##.S.#
    #.........###..#...#....#....###.##....#
    #......C.......#...#....##.....###.....#
    #..............#.........##............#
    #.......C.................###....S.....#
    #.C.........................##.......S.#
    #......................................#
    #.................................S....#
    ########################################
char_to_map_name:
  "#": wall
  ".": empty
  "O": oxygen_extractor
  "G": germanium_extractor
  "+": charger
  "C": carbon_extractor
  "S": silicon_extractor
  "@": agent.agent
  "&": assembler
  "=": chest
