type: mettagrid.map_builder.ascii.AsciiMapBuilder.Config
map_data: |-
  ################################################################################
  ################################################################################
  ################################################################################
  ################################################################################
  ################################################################################
  ##################@.@##########@.#.....##########.....#..#######.######....#####
  ############...##......####...............#..#...........####.....#...#....#####
  ############...##..###..###...........................+..#..........G.....######
  #######..................#.......#...####...............#..................#####
  #####...........................##########........S....##.G.............#..#####
  #####......##..#..#....##........########.............###..........#...#########
  ########.#.#..........######.########.###.C.#.S.#...#...###.+.#........#########
  ############..#...#......#....#####...###...........#....##....#........########
  #######...###.##..........###..###..#..##.##......##....#....#......##...#######
  #######....#####..##.......##.#.##.#....####......#..##.###...#.....###...######
  ######..+.#####...####..##..##..####.....###.#..G.###...###.+.......##....######
  #####.....####.....#....####......##...#..#..#......#######...#......#....######
  #####..##..##.......#..##....#..#.####.##....#....###..######.......#.#...######
  #####........#.#...##.###..###.........###...#..##........####...#....##.#######
  #####.............#...##.#.####.#...S..#.#........#........#....#...##..########
  #####..........##..#.....###.....#....##...#.......#.#.........#...#.#...#######
  ######.....##.#..##.#....#....+.#....#.#....##.....##........###.........#######
  ######....####...##....#....#...##.........#......#...#.....#.##.........#######
  #####......#.......#........######.........##.S.....#...#..#...####.##....######
  #####...#.#####.......##.....#######........#...............##.####.......######
  #####..###.######.#.....#...#..#####.#..#.....###.#........###....##......######
  ##########..######...#..#....#..##.##...........####....#..##....####..###.#####
  ##########...##.####...##.G.##...........#..#....####.#.....#..########.#..#####
  ##########.####.###.####....####...........###...####............######....#####
  ##########.#.##.##..####.#############...###########........##..#######...######
  #####..###.#....##....####.###...................######...####..#...#...########
  #####...##.....#..#........###.C...............O.###.#....##......O.#.G.########
  ######.........#..#.........##...................##..#....##...#....#...########
  #####...G.###..#..#..####.G.##...................##.###...#....##.#..#....######
  #####..........#........#...##...................#..####..........###.....######
  #######.##..S..#........#..###...................#+.###.......#.#.###.#..#######
  ##########....###########...##.........+.........#..#...........#.##.#....######
  ##########..............#....#.........@.........##.#...#....#....#.......######
  ##########..............#.............................##..........#.##.....#####
  #########.############..#............@.&.@...........####.#....#...##.#....#####
  ########...................##........................########....#.##.....######
  #######.............S......###.........@.........#.....######...........+.######
  ######..#...#######...###..###.........=.........#.....#...#.....#...#....######
  #######.##..#.....#.....#..###...................#..#......#.......#.....#######
  #######.##..#.....#.....#....#...................#....##.#.##...........########
  ######..#...#.+...####..#...G#...................##.....##..##.#.....#.#########
  ######...............#.......#...................###....######.###...###########
  #####..........#.....#.....###.G...............S.##......#.####.##.....#########
  #####.........#....####..#####...................###...#.#..###..####...########
  #####.......O...#######..#############...###########.######......#.#.....#######
  ######........#########..#######......#..#......#...........#........#....######
  #####...G....###################............G.####..........#........#.#..######
  ######..........#..##...#.........#.#..##.....###...#####...#..####..###########
  #########...#......##..###..S...###..#####..S.#####.......O.#.....#..###########
  #######.......###.......###...#.#######..##.....####........#.....#..###########
  #######.....G...........##......######..##.#.#..####..#..#..####..####.....#####
  ########..#.............#.....#.#...##.......#..#.....#..#.....#........#..#####
  ######......###..#...#..#....#....G.##................#..#.....#........########
  ######..###.###.##.#.##........##...##........#..#....#..####..##........#######
  #########...###..#..###...##....#.####..#...##........#........#..S.......######
  #########...#...###.##....##...####.#...#...###.......#........#..........######
  #########.G..#########....####.####..##.#.........#...##########..#####...######
  #########....#####..##..######..##............#...#...#........#..........######
  ##########.#######.....#.#..#########....###..#..##...#........#......C....#####
  ########.....######....#..#..#.######....####....###..####..#..####........#####
  ########......#####....#.#.#.#...###....#####.....#.........#........#....######
  #######........##...#..........#..#....#.#.###.#.#..........#.........##########
  ######....####....#.###....#.##..#.....#...###.####.#....#..#...#......#########
  #####.....###..#....#.........##..#.#.#.....#..##........#.....##.......########
  ######.......#....O.#.G...#...###...#.....+.#....#..+.....###.......#....#######
  ######........#...........########..........#..........####...###.......########
  ######......+.#...+.###..##########..#..#####..........###..C.##.........#######
  #######.............###...########..#########...........###...#.......##.#######
  ######..............###..#########..#########.....#...G..##..##....#.###..######
  ######...#.....###..###########################..####....######..#######..######
  ################################################################################
  ################################################################################
  ################################################################################
  ################################################################################
  ################################################################################
char_to_name_map:
  "#": wall
  ".": empty
  "@": agent.agent
  "+": charger
  "&": assembler
  "=": chest
  "G": germanium_extractor
  "S": silicon_extractor
  "O": oxygen_extractor
  "C": carbon_extractor
