type: mettagrid.map_builder.ascii.AsciiMapBuilder.Config
map_data: |-
  ######################################################################
  #....G...................G..##................#...#...............G..#
  #.........................#.......................O.......##.........#
  #..S.......S.S..............#.O...............O......................#
  #...............O.G..............#..........C........................#
  #.S......G.C.............................#...........#.....#......G..#
  #...C......#.G....S.......G..S.S..O.#....................#......S.#..#
  #.................##....C............................................#
  #.G..#.S.....S..C..........#....................S....O...C.......C...#
  #....#.............#....O#....G.#.G.................##.#...O.........#
  #..#..#..........G.........#....#..................O.S.......S.......#
  #.......G.#.............G#...#..C.O+.#...#@......#.##.#.#..#....#...##
  ##........#G....#.....#......O...#.....+#...#....+##+..#+O.#........##
  #....C.S..#.....S.........S....O....##....#........#.O++##.#.........#
  #.........#.....#..#..C................#....C..C.#+#...##+.#...#.....#
  #.#............+#..#..C.............#............#.+++#++..#.#..C....#
  #.........#...............#.O....#G..........G..#.###.###..#O........#
  #..#...G..#...O#......#C.....#..................S..#+#####S#.#....G..#
  #.........#.+..##...O....S.#.#O.............#.....#####+...#..#......#
  #.........#..#...##.........G......#....#.C......####.#..O.#.........#
  #..C.....#..............S.#....@...@...#.........#..#.##+###.#.......#
  #.#...C#.S......+......+.....G.......+.##........C.+.#.G...#.........#
  #.....#.................O+S......#.....#.......S+..........#.........#
  #.........#.O#.......S.+.#.......#.........S.......C.#.....#......G..#
  #...#..#..#.......#..##+#.###+....C.....O....#..................#.#..#
  #.#.......#....+..G..#.O...O.........C.....#.#............#..C.......#
  #O........#.....G....S...+....#.......#...........@+S......S.......G.#
  #.........#G.......O#...G.........C....#..#........#.......#.........#
  #.........##..#....#.......#........@..S..#..#G#++##++#+...#.......O.#
  #.#......##.O..#S...O..........GGG.G.GGGGG......S..#..S...##.C...C...#
  #..#.....G#...S.........G..#.............S+........+.......##........#
  #.#..#......C............C...............S..........S..#...#.........#
  #.........#...+...S...................O..S..#....#.........#...#.#...#
  #.........#...#.......#.......O..........S.....+...#S......#.........#
  #....S....##+####+............O.....@....S....#S..#.#.....+#.........#
  #........O#.G.+...#.....#..........@.@...S.......G....O.S..#....#....#
  #.S..##...#...#.C...................@..#.S.O.........#...#.#.........#
  #...#...........###..........#...........+.................#.#..S.O..#
  #.....S#..C...S.....S......S............#S.O.......#.......#...##...C#
  #.........#.S................#O..........S....#.S.#G.##.#..#...G..#.##
  #........##..#.......#........CCCC...C.C.C.........#....#..#..#.#....#
  #..G...C..##..S.......+.#..................G.......S.......#....O....#
  #..#......##C...#........##..G..S.......#...#.#..C#........#.........#
  ##........##.............................#S#..+.....O......#C...#S...#
  #......O................#..#............#..#...........#...#..C......#
  #...#.....##.........+..+.......C+......+S......S...C..#..##G#.....O##
  #.........##...G#...S.....+#G.......#..O.#..#............C.###.......#
  #.........##.+#+..............S.G...#S.....#..............G#S........#
  #G........#.+..##.G.C....C...........+.....................#..G.C..#.#
  #.....#..S#+................S#......#........#.............#.........#
  #....O....##.....S.........#+...##..+.......#....#....+##.##.S.O.....#
  #.........#+......#....G.....O....+#..#....###.........O...#.....C...#
  #.......#.##....#.........S#........##..#.........##.......#...#.....#
  #.............................G...............+............#......#..#
  #.....................##...S........##...#......G.......O#.#......O..#
  #....S.....#...........O.#..#.................#.#.........##.........#
  #S......#.#..............G.........#.+.....#..........#+.#.#....#.C..#
  ##.....#..#.......#.....#....+..C........+..G....#.....+.C###...S..#.#
  #.....#...#..#..C...#....+..#....+.O.................#S...+#..S......#
  #......S......C.#................#....#...#S...#.....................#
  #....C...........G.G...C.......................................C..#..#
  #...........S........C...........................#.#.......O..#......#
  #..C......G.....G.O.....C...........S.C....#..........O..............#
  #......S#...#...#..........................G.C................##....C#
  #..S.......................G..C........G............G..#...#..C#...#.#
  #.....#...C..S...S...#.........................G..O...#...........#..#
  #.G..G..................#.#..#.....#.........O...........#.....O.....#
  #......................#.............#...#..#........#..#........S...#
  ##.......S#..........#.C....#.............G........#.................#
  ######################################################################
char_to_map_name:
  "#": wall
  ".": empty
  "@": agent.agent
  "+": charger
  "&": assembler
  "=": chest
  "G": germanium_extractor
  "S": silicon_extractor
  "O": oxygen_extractor
  "C": carbon_extractor
