type: mettagrid.map_builder.ascii.AsciiMapBuilder.Config
map_data: |-
  ##############################################################################################################
  #..O...&.#.....................G.S.=..+...=........#=....S......#..........#O.G......G#.+........=...........#
  #......G......&.C.#.......#=....&.#..........C=...G............GC...#....#....=...=..........................#
  #..#.C.O.......#....S..........++C..............#...........&....G...............+.#......#................C+#
  #..#.............=...#..&.#..###+.&.........#.#............O.S....................&.....#...#...#...#........#
  #....#...........=.O+.........&..............S............GC.........O..#.........GC......+.......###........#
  #.#.#..=.....O.......#.....#......#S.#..&.........#=C..=+....OS....O..........#.#.&.....&..OG............#.###
  #.##.S.#.#....&............C+&..#........+.....C..O...C&..S....................SS............................#
  #.....#.+......=....#......#.G.#....C.......S...........S..=......C.O.....O.#........#..........#............#
  #...S.......=......=.=....G...G....+..+C.......#.........G..+...........C......G.#...............#.=...#....##
  #.....#.....#........O.#.=..#...........G.....#...C...OCS..........#......#.+.S.=......+.+...................#
  #......#..C.+.......##.+&.S.......#.#....S&........G......+S...##S....C.......C.....G#............#....+.....#
  #..#..=CG...O...O...=......=#....G..G+G......#.....G....C....#....#G....&S.+...&.#S....G....=.......+.G...##.#
  #....+.G.......O...S....+.....O..=...C....G....#.S............&.........+.....#...S+..#........+.......O.....#
  #.+...#..........G.....=#+&...............O.O...O......C...#+G.O.....#.O....#.G..+S.....&..SGO..C.#..O.......#
  #........+......O......+.....#.....C.S.....O..CG&.......S..........O.S..............&+....S..................#
  #.OO..G#..C...C&........&&.#...O.&.....&#.........C=...G=..S..#C...C...S+.........#...C.....&.S.#......&G#.+.#
  #.#.O....#&G#......+S=S........O.G...=......=.C.+.C..GS=G..O..O...=+G...........C#....=......C...#.=....S.#..#
  #...........C..&...S......GO..=.......=..O...=..=&.......&&..........&..+...............CC..+.....#&.##.....##
  #.............G.....G+........@.SS...........=......+.O.&.+..=S.C......#...O#...G..#&...G#...+O.+&...........#
  #...O.................S..+G.O......&G.....SG.G..O..+=.G...O.......=.=..O..O..G.....O...###.......S&........GS#
  #.SCS.......#..+.......GGG&..........G.+..GO....+..=.....=O..C.C=.SC.....G.....GO.+..&.G..=......+OG.........#
  #.G...............+.S....C&.+...G....G....O=...S..+..&.C.+.GG...+G......=..G=..G......O.#....................#
  #.#..=#...&.........#.....#..G....O.S..+=..SGCO.....S....S......O.....OG.........O.........G..#........G.=...#
  #..........+....#.+.......O.G.+C...........S..O..+=...+.&.&+.....S.S..+C.....S..S&...+.+SC..O.......&........#
  #....O.C....................CSC...C....G....S....&CS..C+G...............C..+.C.......+...+..S....#......=....#
  #....S+.#......#..............CS.S.....+C.....&&.+.&.....+G..=#.&..OO+G...OC.....++&.........................#
  #O..#...S..=.....=.....G..S.SC.&..OSS...+.G..S&.&&...&..+GS..SCGS..C.=...&....C....S..C...................#..#
  #......#.........#.........G=..O..G...+GO...+=..&.+...OG...O+G=.S....CG...GC....G.=....&O.S..S#..+...=.......#
  #....#.S...#..&..=......C.CO..=....O...S..=...+..+C.+S...+..O..=.......SS.G..C.+.+..C......OS..+........#....#
  #......=.........S.&G...O..G...=O#.......=.G...G.S.&....+=O.&..S.G&...=G...&..G......S..C......#.............#
  #..O....O.S....+.O.O...C...+C.....G.....&.G...&.....O...G..S.OC++..+...+.G....+O....O..G..SS...#.#.O.....#...#
  #...&.....G...+....O......&.........S..C+S..S&=.=...OG==O....+.O+&..&G=..C+C+.&.+.....C...C...=S....#+#.#..C.#
  #...#..+....&.....O...=CS&G..S.....C.O......CS+OGS...=.....O..SO.S............C.G.....G.....#....C......C....#
  #&.#....++................S.....G.S....+.....S=C..GO...S....G+GG.&....C.......&.G.SC...CSG.G...G.............#
  #....=.......S&...C..&+..G..........=.O....G....G.....C..GS...+.O.C........S.GS.....G+.+G....#.+.C...S..&...##
  #...........G+....+...G=.....+#......+SO.C.GSS.+=C.+..O..G....+#S...O..G..O..G.......=GG..................G.##
  #....#.....#.....&......GS..O.C.SS.C+C..+.GS.G....=......S+.....=..S...SO.+.+.+......#.#S.&............&...+##
  #.......+=...#........=.....&=.O&C.....G.....OSS&+O...O.S..&OGCG+.......GG+&G......#S..G...C.......C.........#
  #+..C..=CO.............S=.+...+S.O...+....&...&S.&.@.S...O=...+...OG.&.CG.........=.+...&.........S...#.G....#
  #...#.......C..................G=.......O.&&.S+..OC..+.O..SC.S.G..+...G.............+.+..C.G.....O...O..&....#
  #O&..........#.&&................G........CS.&.......+.OS..CC.&.C..G&...SGO&..&..O.O........G.GG.....O....#..#
  #..#+G....S.................O.C.&&=S...&.G....G....C&C..OS.O....&.&..C+#..C.S.SS.G.+.....G.#...C...S......#..#
  #..O............G+...&S.....S...+...SG...+.G..GS..GC.+.+...S......&+.O....O...O..CC#....OO...C........#......#
  #..#...=.=..GC=....++...&..&.C.&.O..@.&+........S..GS.CC+..GS=...S.....&.S.=..O#=.#+....&....=.&........+....#
  #........#..G........C.G.&S+.&.C+GG...C.C+..&C+.O=+=..O=G.....&=C..++..C..+..............G..........GC.C.....#
  #O........#..G.......SC.O...=.=.S.......C...+.=&.+O..G.C+..+.&.O.G&.OS+.C+......S....CC..&+.S...&.#C.#.&.....#
  #........#+&.OS.S......GOS..++.G&....CO..&S.+G.=.GO..O.OGS&.O+&...SG&O..+S..C.&OO.......G....C.......C.#S....#
  #...#...+....O..C....O&.C&+..S......=+.SSO....SO.+.SO..+OS..=C...&G&&.++S&..S..C....CC.SG...OS......&O.O.....#
  #..CS...O.......S.O.........G=C.+.GO+G+..&G.+G.C.=..C+GG.SG.&...+..=.....S.S=.OO&+......&.....G..+........#+C#
  #.&..+........O.CCS....S......&..C...+...C....O=&.O=..+=.&.....O.G..S+....=....&....=S+.O....C##C..+.....=...#
  #..=....&.....S..O.+&....O....&..OG.....O.GO.G.O+S.G.GSCCO...C.C.S..O&=G.=..G=.C.....S..........O..CG.....#..#
  #..#C.+...&C....+..S.....S...+C.+..OGG&.&++.O...+=OSS...C=.++C.C.S=.C.O.....O...G...G........=.C.......C.C..=#
  #....#......C+......@=SCO...+.....C.C.+...G.GC.+OS.GO..S..G.C&...+.S.GS=...+.+.&G.&..+=C&#=G..S.........#....#
  #.=......&.CC...C..+.....&...S.S.#.....CG+.&C...+@G.S.+C.+..+&=+......=..=....O..C==....==.G....C............#
  #...+&.#S..+&....=O......G.O...=...=..+CC..G=+.+&C.S...O.O+.C&.....+.C.&G.O...G&G......S....+SS...O.....G....#
  #.=.#.&...=......C......+.G.....&.S.+G..........+.....O..+S&CG.SGCOGCG...S+SG...=S........=SO..+..=..G.....#.#
  #.............#....=.O..+S.&..S..&+=#G...G..+..=.S.&.&GG..++.C..CG&+=G.O.O........S...O...+............G.#..##
  #.&............C.......OGC+.#+=CGO...S.SG.....S..C.&...=G+O+.SS&C&.&.CCC......SC.=..O...C.G....G=.G.+#.O.=.G##
  #....O.##......O..O.....C##..O...&.........C..GG..GOG++O...GSS..=.G....=C....&+..#.=G...S...+.......+.....#.=#
  #....O..........S&&+.G...C...S...SO..=+O.G.++S.C.&&.&.S..O=..&&O.G...=&O...SS+.S.CG..SS.........&..=C...##C..#
  #=...........G.....+..S+.......O+..SS.O...=....S..S+..==CGG=..&..C..+.CS.GGC.....O+.#....&C......+C........+.#
  #.....+...=.....+........+...O.#.+.G............G.GG.O&+.G.=..=O&.SC..G.+G.=.OS...G....=.O.+...&.....#.....S.#
  #...........GS.C.....GG.C.=.O&&.+.....S.C....S&=.C&=&.+=.+G.&G.+.C+...C++...S&..==.....+..G......#...........#
  #......&...+..O.SS..S@&.G=..=......+G.+=....&.&.C....G.C...C.GSSG...&.C&.+....&=..G..C.&++.&...&=......+G....#
  #....G.=..&.....&..&...........+...C...+.GS..&+G..&=.&.G.=GS...S=.......SG.++SS+.G.....................G.....#
  #S....O.....GC.CC...+....C.+.+..S..=&OC.S=.==.S...&.+&O.=OG..&....O&G+G..S..OS..O.CO...#....OG......#.S..G...#
  #..=....C..........+...S+.C..O....++G.O.....+.&.&..O...C..=C.+.S.S.+C......G...O.S...........&..G.....&&.#=..#
  #S...O..S.....G.G.#..C.=.....S=...=..G&.SO.....=C...&.=..C..&O.&++.G=SC...+..G..O......O..S......GS.........##
  #..........+.......G....S.+.S+SOC.GO..+..G.....CG...+.......C.SC..GG.GS..OSO&=..C=.+...#.C+C..=.S....&.......#
  #..O.#S.#..&&=C...&O#&G..C.GG.OO+&..&&...G..C..+O.+...O....+=+.+..+.G.+O....C+.&S.C..=....G..S...........+...#
  #...&###......+...&OS.=.&.C.S....OO.......S..O......S.G.S.+..S...G.S....O....+.O.=..+...+....S...#O.G....#...#
  #...+......@.....=.=G....G....+.S..&+...+G.....GCC..+......&.G...=SG.....G...+..........S...C.....=.=C..#...C#
  #..C......=O...........S..O..=.........&.&...&..C..=.&S....S.....=+.&.O...==CC#....&.=.....S&..&+....#=.#..C.#
  #....&...........S...O..+...S..&+.........&.....C..+.C.OO.GS.G+.&&.OGSSG+.....G....=....G.G...#......C.......#
  #......&..C........G+G.+#C.O.+.G.=#..GS........+GGO..=.C+..+&...G.....S....CG.+..G.....S=...#S.O.............#
  #.G................O.....O.GS.....=++..+..C.G.CS.O..=.O.=.=&.O......&..==C.G......&....&.....#.G........+...&#
  #..........O...=...C....&O...CC.S..OC+......C..O.CO....C....+.O.....C.......G...S.S....S...S..........O.#....#
  #=S.S......+.....C.....SC..+.C&..O.O..........+G..&.C.....CG.....S.C.G.G..OO.......&.S..OO.+..C..O+O...+...SC#
  #..S.........#......=.=.C..C.G.&..#..+..........+C=&+....CC&...=...G.G......OO...#O..+.........##.....=...S..#
  #............S.........&#G.C.G..SO#..+..S.S.G..&S.+..=+....SO.O.C+......CS+C.+..........................CC...#
  #.....#...&..C.......C..........#..O..C&.&.+SC.=..G..+.....G.S..S.+.......+......=+.&.O.#S..S........S..+.G+.#
  #.#..#....C..............O......+......++..S..S.......+&S.=....&..+......++.=+.S............&...........O.#..#
  #...........#..O.=..S.S...................G.+GOCG.SO........&G.O+O.+....&&..=.=..CG....+&=.#...............###
  #..#.....#............O&O..=........#....C..CGG....&.CSO....G.+...+G.......GOCO......SG.O........=&.......O.##
  #.....#.......#..+..O........CS.G..G.O=...G......++...=....S=..&S.....+&..........+S&G..............#..##O...#
  #.....#....&.#..........#..O.......G..........+S..O...OC&=S.GO..+.&+.&G.=O&..S...=.................##.+.+...C#
  #.....#...#...#.O.......#....O...C..OS....G............O.G..O...O.=.....S..+..=.#=....&..+......O.S..........#
  #......S...#.#........O.C..S........C.......G.S.S.O.S....O.........GG.....G+......&........&..=..#.O.....O...#
  #..#....&........&...#...G..G.O.....G.C..O=.O.O#..OO...=.....+....+.G..+..G.................#............&.S.#
  #.............+..CO.....+..S....OCS......+.O....SG..+...+OC.#......#.....+......O....C.O..#...+...C.#......C.#
  #................S.+.=+........S.=.........+.O..+C..C...O.==.C..#.O.=.C..+.@CSC=...G=.....S...........#..C...#
  #...#..#...G&...#...S..S...O...=&.S....OS....G..+...C..S...=........+.++&.....S..+..S.........C.#...G......#.#
  #........#.#............@C=#......OO.&..O..O....S..GCC+.S&...=S..&.G..G=....S................#=G......#.+....#
  #..OG.+.............C...&..................SC.....G+.......+.........=....+.............#...+...............##
  #...............C.&....#....+#+..+.............&#.+..=.&..O..................C....S..#......#G.....=.........#
  ##.#..#.....=&.#...#....S.C.......S.+#......#...S.S...=.....#=..G.C..O+#......&..........S.#...#...........#.#
  #..&.....#....&......C.#.....#S....&G........+...#......#........#.&............C....#.#...&.C#.........#.+.+#
  #........#........G.........S.#+....#..G.....G........&#.....=.&...G.G...#.C...=.O.......G..............#....#
  #...........G.O..+.#=.C.GS..O......O=.........=..............+..........G........@..=....S.O.#.........#.....#
  #............G..#.....................#..#.++S..+...#C.S....GG...+.CG.........G...#.............G...........=#
  ##&.....G....+..O.....#...G.+G..CG#.........+S.......CG...............S.O...=O..C.+.........=...S..+......C..#
  #....C.#...........S....+C.G+...#.....#...#S..#.O...C.#.....C.........G..........S..#........&...S.#.C......O#
  #..#.=+.+..+......&.#.....O......&#......G#.+..S.O..O..+.......O..S.+.....#.....C.......#........#...O.....+=#
  #.....#.#..O....#..&.......C..G............#..#.O...O..........C.......S...................................#.#
  #....S.....#..+.C...+...#.G....G+....#..#.............##..#..........#...C...............#..#.....##.........#
  #.....#................O.#.....=......S...C.#........+..O............+..........S.....................+......#
  ##############################################################################################################
char_to_map_name:
  "#": wall
  ".": empty
  ".": agent.agent
  "+": charger
  "&": assembler
  "=": chest
  "G": germanium_extractor
  "S": silicon_extractor
  "O": oxygen_extractor
  "C": carbon_extractor
