type: mettagrid.map_builder.ascii.AsciiMapBuilder.Config
map_data: |-
  ##############################################################################################################
  #............................................................................................................#
  #............................................................................................................#
  #.....G..S...................................................................................................#
  #......&..=..................................................................................................#
  #............................................................................................................#
  #.....O..C...................................................................................................#
  #............................................................................................................#
  #@....................................G..S...................................................................#
  #......................................&..=..........................................@.......................#
  #............................................................................................................#
  #.....................................O..C................................................@..................#
  #............................................................................................................#
  #.........................................................................................@.@................#
  #.......................................................................G..S.................................#
  #........................................................................&..=................................#
  #............................................................................................................#
  #.......................................................................O..C.................................#
  #.......................G..S.................................................................................#
  #........................&..=................................................................................#
  #............................................................................................................#
  #.......................O..C.................................................................................#
  #..............................................................................................G..S..........#
  #...................................................................................@...........&..=.........#
  #............................................................................................................#
  #..............................................................................................O..C..........#
  #............................................................................................................#
  #............................................................................................................#
  #.....................................................G..S...................................................#
  #......................................................&..=..................................................#
  #.........................................................................@..................................#
  #.....................................................O..C...................................................#
  #............................................................................................................#
  #............................................................................................................#
  #...........G..S.............................................................................................#
  #............&..=............................................................................................#
  #............................................................................................................#
  #...........O..C.............................................................................................#
  #............................................................................................................#
  #..................................................................................G..S......................#
  #...................................................................................&..=.....................#
  #............................................................................................................#
  #..................................................................................O..C......................#
  #...@........................................................................................................#
  #...................................................................................................@........#
  #.............................G..S...........................................................................#
  #..............................&..=................................@.........................................#
  #............................................................................................................#
  #.............................O..C...........................................................................#
  #............................................................................................................#
  #.................................................................G..S.......................................#
  #..................................................................&..=......................................#
  #............................................................................................................#
  #.................................................................O..C.......................................#
  #............................................................................................................#
  #............................................................................................................#
  #....................................................................................................G..S....#
  #.....................................................................................................&..=...#
  #............................................................................................................#
  #....................................................................................................O..C....#
  #............................................................................................................#
  #..........................................G..S..............................................................#
  #...........................................&..=.............................................................#
  #............................................................................................................#
  #..........................................O..C..............................................................#
  #............................................................................................................#
  #............................................................................................................#
  #.................G..S.......................................................................................#
  #..................&..=......................................................................................#
  #............................................................................................................#
  #.................O..C.......................................................................................#
  #............................................................................................................#
  #............................................................................G..S............................#
  #.............................................................................&..=...........................#
  #............................................................................................................#
  #............................................................................O..C............................#
  #............................................................................................................#
  #............................................................................................................#
  #...................................................G..S.....................................................#
  #....................................................&..=....................................................#
  #............................................................................................................#
  #...................................................O..C.....................................................#
  #............................................................................................................#
  #.......G..S.................................................................................................#
  #........&..=................................................................................................#
  #............................................................................................................#
  #.......O..C.................................................................................................#
  #............................................................................................................#
  #............................................................................................................#
  #.............................................................................................G..S...........#
  #..............................................................................................&..=..........#
  #............................................................................................................#
  #.............................................................................................O..C...........#
  #............................................................................................................#
  #.................................G..S.......................................................................#
  #..................................&..=......................................................................#
  #............................................................................................................#
  #.................................O..C.......................................................................#
  #............................................................................................................#
  #............................................................................................................#
  #..........................................................G..S..............................................#
  #...........................................................&..=.............................................#
  #............................................................................................................#
  #..........................................................O..C..............................................#
  #............................................................................................................#
  #........................G..S................................................................................#
  #.........................&..=...............................................................................#
  #............................................................................................................#
  #........................O..C................................................................................#
  #............................................................................................................#
  #............................................................................................................#
  #............................................................................................................#
  #............................................................................................................#
  #............................................................................................................#
  #............................................................................................................#
  #............................................................................................................#
  ##############################################################################################################
char_to_map_name:
  "#": wall
  ".": empty
  ".": agent.agent
  "+": charger
  "&": assembler
  "=": chest
  "G": germanium_extractor
  "S": silicon_extractor
  "O": oxygen_extractor
  "C": carbon_extractor
