type: mettagrid.map_builder.ascii.AsciiMapBuilder.Config
map_data: |-
  ##..#.#..+...##.#....#+...#..#.+#....+....##....###.#+.#.+++#..#+#....+#.....+.......#.+#...+#.......++.##+.+#
  +...#.......+....+#...#...............................+...............S.......G.......S.+#.#.......#..#....+.#
  #......................+.......#.....O..#..S#O.+.....+............+.......#....#...G......#.....####++#++#####
  #...+.&++........#....+...O....+...#.........#O........&.........=.#....G&O...............+...........+C.....#
  #.#...&.............&.....+...........................C.O.....G.............+.C.+.#........#.#.+......#......#
  +...........##+..........&...........&.......G........&......=.......................+...O..+.#.......+......#
  #....+.....+.#...........+.................................+.@...........C........#..............+.OC.+..#...#
  +#.&.+..........#............#.....&.......G.........#.......#.#.+S.#.........C.................O#..#...+....#
  ##................................C..........#......+.+...=.......#............G....&....#........#..#.......#
  #.....O..............................O.........&..#....................=.................#.....#.++.........##
  #.......+.+##.+#...#.......=.........S.#............+.............+.......+............=.#=.#....S+..........#
  +....=..#+...#++.##...........................................C....+.S.......+....+.....++.=......#.......=..#
  +.......#.#.....+.#+...&................................+..O....=CC........S.........##++###+.+##+#####.....+#
  #+..#...##+.#.+#.###........#..........G.......#.........................................#........#......=.+.#
  #........#.####..+#............+.............................#...........................+........#G.....#..O#
  +....#.++.C+.#+..##+...........#...#..........#....SG.................=.................O+........+........+.#
  +#.....................+....................=..................C......@..............=.#.#......=.+..........#
  #..................................+........#............+.+.=.S......+....#........#..S.....#O..........C.O.#
  +...................O.......+O..........+................................#.#......S..................&.#.....#
  #...+.........+=.=......#.+...............+..+#......#....+...&.......C.##++###........+.....................#
  +...............#...+................S......................=.....C.....C..#S.....G....#...#.............#...#
  #.##...............G..................C....#.........+...........+.G.......#...O.............................#
  +..........+........S................................S.........C.................+......O.O....+.......#....G#
  ++........#.......................#....+...........................++...+...SG....+..............#O...##....+#
  +.##.+..#......@..............................O............................&..+......S@.....&....+........C#.#
  +#.&........S.............+....#.......S.......................C#.......+....=......++.....+###......S...#...#
  +..SS...........O..................#..#..C...........=.....=...........&............=#.......+...+........#G.#
  +.............C....S.............G.............=O........S.......S#.+.+...............#.......&....O.........#
  #.#....................G...............#.&............=......##..........#.........+.+......................+#
  #....................=.............+...............O....&.....................................G..............#
  #...=...=&....+..........O.........&............#..C.O+.....#@......#.##.#.#........O#.#.................C.+.#
  #.......................+......+..+#......................+.........+##+..#+O...........C...S...........+.+..#
  +..................#...............S...............+..................#+.++##......#......O.......+.......#..#
  #.&......................................C.....................C....#+#+..##+..C...+......+..+.........O.+#..#
  ##...##+.................#........+#.....C........=....#.+..........#++++#++......#..#....+..+............#G.#
  +.................+.....S..............+.....#.....................#.###.###.........=.##+##++######.......#.#
  #......................C.+O..+....#......#....=.#.............&.......#+#####S+#.=...++#+++++###.&...........#
  #+...........#.......#.........+...#..........#.................&....#####+....#..........#..++...#.....#+...#
  +.....................................................#.............#.##+#++.......+......#..................#
  #...+....................=........................@...@...#.........#.+#.#.+#....O........#+...=..O..C.....+.#
  #+...=.............................+......+.....G.......+.##..........+....................#.........+....=..#
  #..O.#......................................+.............#........+.................+.....#...............O.#
  +.+.............#.......................S.+.#.........................C...........+S.......#.#.G.O...........#
  +..................+....#S..............##+#+###+......+..+.......................+C......G#.+=+...#.........#
  +..................CS...=....G....+..G......+....................................O+......##+++...............#
  #.......G....................+.....G....S...+........................@+...........+........#...G#......&.....#
  #..+.......S#.....C.#............................&....................#...........+....C...#...C..........####
  #.....+......#....+........#..#..#....#.......#........@..S.....#.#++##++#+....##+##++.....#................##
  #..........+......=.+..........O..........&.=.+..GGGGGGGGGGGG.........#=..........#...=.+..#.....+..=.#.....+#
  +................................S.........G.....O..........S+........+..&...S....+........+...O.............#
  #.........#......#........O.................C....O..........S..........S..........#.............#+.......S...#
  #...#...@##..O...#...=...........+.......=.......O.....+....S.....................+........#.....&......#....#
  +.##....G.#....=.................#...............O..........S.....+....S..........#........................+.#
  #...+...................#.....#+####+.....G......O.....@....SG...#...........+O...........................&..#
  #..............................G.+&......+.#..&..O....@&@...S.........................+........#.............#
  +...+...........#..C.............#.C.............O.....@....S...........#.........=.......+#....S.....+...+.##
  +.....+........+...S......S...#..................O..........S+...............................................#
  #.............#......&......+.#..S.....S......S..O.....=....S.....................O.......O..............O...#
  #.....=....@........#...C..#......&...=..........O..........S.........G.##.#........+.........+.......G......#
  +.#......G......................#........C.......CCCCCCCCCCCC.C............#.....................##.........+#
  #..#+#.+..###..........+G...O##......=...+.#............&.....G.....+...................#......#.........+...#
  #..#.#..##.#+.......#.G.....#.#C................G.........&......#..................S....................+...#
  ++.......#.##...&...+.........#.............................#S...+.........+............+.......G.=......#.+.#
  +..####...#.#.......##........#.C.=........#...............#..#.............................C...........+#...#
  +..#.#.+#..++....+......+..&..#.........+..+........+......+.......S......#....#..&.....+#....=.C........+#..#
  #+.#.+....#.##......C.........#....#.........+..............................C..#....................+#+###+###
  #...####+.#++.............+++##++#+................G...#......#...........&..G.#.........................#.&+#
 ##.###+##+##+++................+..#...+C................+...................&..O+..G..G..........C..C.....+...#
  +..#..@.+................C....+................S#....&.#........#.....G........+.........................#...#
  #.&#.+.G......................#.&..............+.......+.......#....#....+##+#++##+###..................#+..##
  #.......+....#...........+&...+...........G.....O....+#++#....#.#..............#..........#..+.G.........+...#
  #......#+............#.....#..#...............#........##......+...............#..+&.........................#
  +.#.....+..............&..+#...........................+.........+.............#.............................#
  #.........................................#............#....#.....&G........#..#...#......C.......#...#.+....#
  #..#+....O.+...............=.......................&...........................#.......#..G................#.#
  +#.G......#.................C....C...........==.......#.+.................+..=.....#.............G...........#
  +............#.....................&............+...........+=............+..#........+#..S..O.=.............#
  +.+.#...........#...............#..C..=#....+.......+....=...................+.....#.........................#
  +#+.#........&....+..............................+.........G..................#.........#............+.......#
  #......................C.........&..............#......#=............&............+........G.................#
  #..+.................@.....+..................###......#.....##.........................+.#+#..+.+#+#+#......#
  #..+#......................................O....+O.............#..@...............+....=+#.#.#.#O.#+#+#..#...#
  #..............+...O...........S.......C........#...................#..........G....S...#.+##.+.#.+##.#.+##.##
  #.......................................S.....C......S.....O.G...#....#....+.............+++.###S+#+++..#...&#
  +.......G......C......G..............................+..............+....+.+.G..........+.+.#.#.#.+.+##G..#..#
  #..#...O.............&...=.S+#............G.....SO....G.+.............#..@..............+##.+#...#.##........#
  #...#C#..G..............................#.............&......&.......#&...#..G.....@............+...........+#
  #...S..........#.............................................#.#....#....O..........................@........#
  #.......+.....@.................................#....................#.....#..........C................&.....#
  +..+....+G.................#......................=..........................+.........................C.....#
  +&#..S..........+....&.G..#.+....................O....................#...#........................=.=...+..=#
  ++.........................+.......=&......+...........+.....=....G##.................&..........#.....S....##
  #...#.....S.............+........&..#.....=................O.+.................C.........C........+..........#
  ++.............S.....+.C......O#....+....#...........G....#...........+...#O.................=.......+.......#
  #.G..................+.........+.C........+..+...+#.....O.........O+..C...G..&.....#........G...........S...+#
  #.................O..#...+#...............=................&+..............G...............+..+..........#...#
  +.#............+.+.#S.....#..C=.........C.....O.......G.........+.O=..............+................S.........#
  ##+..........@......++.+##.C#...........S......................+#.........+.......O&....C.............S...#..#
  #......................##+#.+.......+S.C..........O......&.O...++.............+...C......C...................#
  #.........................+.+..............O.............S.....#++..........................................+#
  +.#.....+......O......+...+.G..........................++......##...+#+.....#+....O...............##.........#
  #...........##......#......&.O..............+#.............#+#++####++.G......+...................+..........#
  #........#..&C.........#............=#.......=#..............###++..............S.........#...G.......#......#
  #............+.#....=.+..................+.......+.........&SC.++........................+...+.........G..#+.#
  #...+#...#.#.......#.....O..&.................#................#+.....+........+...G..................+...O..#
  #..................#..S.#.......#...........+..C#G.........#.+.#+...S......+..#....................=.+#......#
  #.........&...............#.+#..S#.......#........&............#+....+.............#...+.+........#.&........#
  #++...#.+......+....#.++..#.+..#.........++#.....###...+.#...#+.###......#..#+#.###.+...+....#.+.......##..+.#
char_to_map_name:
  "#": wall
  ".": empty
  ".": agent.agent
  "+": charger
  "&": assembler
  "=": chest
  "G": germanium_extractor
  "S": silicon_extractor
  "O": oxygen_extractor
  "C": carbon_extractor
