type: mettagrid.map_builder.ascii.AsciiMapBuilder.Config
map_data: |-
  ##..#.#..+...##.#....#+...#..#.+#....+....##....###.#+.#.+++#..#+#....+#.....+.......#.+#...+#.......++.##+.+#
  +...........+....+....................................+...............S.......G.......S.+..................+.#
  #......................+.............O.....S.O.+.....+............+................G....@...........++.++....#
  #...+.&.+.............+...O....+..............O........&.........=.......&................+...........+C.....#
  #...................&.........................................G.............+.C.+..............+.............#
  +.............+..........&...........&.......G........&......=.......................+...O..+.........+......#
  #....+.....+...............................................+.@...........C.......................+.OC.+......#
  +..&.+.............................&.......G.....................+S...........C.................O.......+....#
  #.......#..#........................................+.+...=....................G....&...........#..#.........#
  #.....O..#..#........................O.........&.......................=.........................++..#.......#
  #.......+.+..#+............=.........S..............+.........@...+.......+............=..=......S+.#........#
  +....=...+....++..............................................C....+.S.......+....+.....++.=..............=..#
  +.......#..#....+..+...&................................+..O....=CC........S...........++...+.+.#+.#........+#
  #+.......#+.#.+........................G..........................................................#..#...=.+.#
  #.........#..#...+.............+.........................................................+.......#.G#.......O#
  +......++.C+..+....+...............................SG.................=.................O+........+........+.#
  +.......#..#...........+....................=..................C......@..............=..........=.+#.........#
  #........#..#......................+.....................+.+.=.S......+................S......O...#......C.O.#
  +.........#..#......O.......+O..........+.........................................S..............#...&.......#
  #...+.........+=.=........+...............+..+.@..........+...&.......C...++...........+.....................#
  +.......#..#........+................S......................=.....C.....C...S.....G.............#..#.........#
  #........#..#......G..................C..............+...........+.G...........O..................#..#.......#
  +.........#+.#......S................................S.........C.................+......O.O....+.#..#.......G#
  ++.....................................+...........................++...+....G....+...............O.........+#
  +....+..#..#...@.....#........................O............................&..+......S@.....&...#+.#......C..#
  +..&.....#..S.......###...+............S.......................C.............=......++............#..S.......#
  +.........#..#..O..#####.................C...........=.....=...........&............=............+..#......G.#
  +.............C...#S#.###........G.............=O........S.......S..+.........................&....O.........#
  #.......#..#.....###...G##...............&............=............................+.+..........#..#........+#
  #...........#...###..=..###........................O....&................................#....G...#..#.......#
  #...=....&...#+###.......O##.......&...............C.O+......@......................O...###......#..#....C.+.#
  #.............###.......+.###..+.....................#####+.........+..+...+O..........#C###S...........+.+..#
  +.......#..#.###...........###..@..S...............+.#####.............+.++...........###.O##...#.+#.........#
  #.&......#..#.###.........###............C...........#####.....C.....+.+....+..C...+.###..+##+....#..#.O.+...#
  #......+..#..#.###.......###......+......C........=..####+...........++++.++........###...+.#+#..#..#......G.#
  +...............##+.....S##............+.............#####.........................##=...+..++##.............#
  #.......#..#.....###...C#+O..+..........######=....#########..&........+.....S+..=###++.+++++.##.&.###.......#
  #+.......#..#.....###.###......+.......########.#############...&.........+........###.......++#...#####.+...#
  +.........#..#.....#####..............#############..#####..###.........+.++.......+###.....############.....#
  #...+...............###..=...........###.....####.@..#@###....####....+....+.....O...###...+###=..O..C##...+.#
  #+...=..#..#.........#.............+###...+#####G#...###+#......####..+...............###.#####.#..#.+....=..#
  #..O.....#..#......................###....##+...##...#####........#+#................+.#######....#..#.....O.#
  +.+.......#..#.....................##...S#+#.....##..#####.........###C...........+S....#####..G.O..#........#
  +..................+.....S........##.....#+.+...+.##.##+##+.........##............+C.....#G##+=+.............#
  +.......#..#.......CS...=....G...#+..G..##..+.....##.#####...........##..........O+.......#+++..#..#.........#
  #.......G#..#................+...##G...#S#..+......########..........@+#..........+......##....G..#..#.&.....#
  #..+......#S.#....C.............##.....##........&.##########.........##..........+....C.##....C.#..#........#
  #.....+...........+.............#.....###...........###@##S.##.....++.#++.+......+..++..##...................#
  #.......#..+......=.+..........O#.....##..&.=.+.#....#####....#........=..............=.+.......#+.#=.......+#
  +........#..#..................#.S....##.......##....#####...+##......+#.&...S....+....##..+...O..#..#.......#
  #.........#..#............O...##.....##.....C..#.....#####.....#.......S...............#............#....S...#
  #.......@....O.......=........#..+...##..=....##.....#####.....##.......##........+...##.........&...........#
  +.......G..#...=.......###################################+#######+####S################...........#.........#
  #...+....#..#..........########+#...+#####G##...#########S###G###############+O#########..........#..#....&..#
  #.........#..#.........########G#.&.#####+###.&.##C###################################+#.........#..#........#
  +...+..............C...##########...#########...##################################=#####..+.....S.....+...+..#
  +.....+.#..#...+...S...###S#########################@########+##########################........#..#.........#
  #........#..#........&....##+........##S......S#.....##S####...##.......##........O#......O.......#..#...O...#
  #.....=...#@.#..........C.#.......&..#=........#...S.#####.#...#......G.##........##+.........+..#..#.G......#
  +........G...............##.@.........##.C.....##....##....##.C#.......##.........#.........................+#
  #...+..+#..#...........+G#..O........=##.+......#....##.&...#.G.....+..##........##.............#..#.....+...#
  #........#..+.........G.##.....C......###.......G##..##...&.##........###........#..S.............#..#...+...#
  ++........#..#..&...+..##..............##.........#######...#S...+....##...+....##......+.......G#=.#......+.#
  +......................##.......C.=....###..........#######..##......###.......##...........C...........+....#
  +.....#+#..++....+....##+..&............+#.+........+#####.+..##...S.##........##.&.....+.....=.C..#.....+...#
  #+...+##.#..#.......C.#..................##..+.......#####....##....##......C.##..................#.+#+......#
  #.....##+.#++#.......##...+++..++.+......###.......G.#####.....##..###....&..G#..................#..#......&.#
  #....+.#+..+++......##........+......+C...###..........+##......#####.......##O+..G..G..........C..C.....+...#
  +.....@.+#.#.......###...C....+............####S.....&.###......####..G....###.+..@.............#..#.........#
  #.&..+.G.####.....###...........&............##+#......+##....######.....+##+#++..+...............#..#...+...#
  #.......+###########......&...+...........G...##O##..+#++#..#####.###########.##.............+.G.#..#....+...#
  #.......+.#########.............................###############+...#########...##..&.........................#
  +.......+..#######.....&..+..........#.............####+####........#######.....##..............#..#.........#
  #........#..#.......................###..............#####........&.....##.......##.......C.......#..#..+....#
  #...+....O#+.#.............=.......##.##...........&.#####.............##.........##......G......#..#........#
  +..G........................C....C.....##....==......###+#..............##+..=...##..............G...........#
  +.......#..#.....................#.&....##......+....#####..+=...........#+.....##....+...S..O.=#..#.........#
  +.+......#......................##....=..##.+.......+####=................##.+.##.................#..#.......#
  +.+.......#..&....+............#..........##.....+...#####.G...............##.##.................#..#+.......#
  #......................C.........&...@...##.............=............&......###...+........G.................#
  #..+....#..#.........@.....+............##...................................#..........+..+...+#+.+.+.......#
  #..+.....#..#.....................##...##..O....+O................@...............+....=+.......O.#+.+.......#
  #.........#..#.+...O...........S...##.#C.......................................G....S.....+...+..#+.#...+....#
  #...................................###.S.....C......S.....O.G.............+.............+++....S+.+++......&#
  +.......G..#...C.....................#...............+..............+....+.+.G..........+.+.....#.+#+..G.....#
  #......O.#..#........&...=.S+.............G.....SO......+................@..............+...+.....#..#.......#
  #....C...G#..#........................................&......&........&......G.....@............+#..#.......+#
  #...S....................................................................O..........................@........#
  #.......+..#..@.......................................................................C.........#..#...&.....#
  +..+....+G..#.....................................=..........................+....................#..#.......#
  +&...S....#..#..+....&.G....+....................O...............................................#.=#=...+..=#
  +..........................+........&......+...........+.....=....G...................&................S.....#
  #.......#.S#............+........&........=................O.+.................C.........C......#.+#.........#
  ++.......#..#..S.....+.C......O.....+................G................+....O.................=....#..+.......#
  #.G.......#..#.......+.........+.C........+..+...+......O.........O+..C...G..&..............G....#..#...S...+#
  #.................O......+................=................&...............G...............+..+..............#
  +.......#..#...+.+..S........C=.........C.....O.......G.........+.O=............................#..S.........#
  #.+......#..#@......++.+...C............S......................+..........+........&....C.........#..#S......#
  #.........#..#...........+..+.......+S.C..........O......&.O...++.............+..........C.......#..#........#
  #.........................+.+..............O....................++..........................................+#
  +.......+......O......+................................++.......@...+.+......+....O..........................#
  #..........................&.O..............+....@..........+.++....++.G......+...................+..........#
  #...........&.......................=........=..................++..............S.............G..............#
  #...................=.+..................+.......+.........&.C.++........................+...+.........G...+.#
  #...+....................O..&...................@...............+.....+........+...G..................+...O..#
  #.....................S.....................+..C.............+..+...S......+.................................#
  #.........&.................+...S.................&.............+....+.................+.+..........&........#
  #++...#.+......+....#.++..#.+..#.........++#.....###...+.#...#+.###......#..#+#.###.+...+....#.+.......##..+.#
char_to_map_name:
  "#": wall
  ".": empty
  ".": agent.agent
  "+": charger
  "&": assembler
  "=": chest
  "G": germanium_extractor
  "S": silicon_extractor
  "O": oxygen_extractor
  "C": carbon_extractor
