type: mettagrid.map_builder.ascii.AsciiMapBuilder.Config
map_data: |-
  ###############################
  ###############################
  ###############################
  ###############################
  ###############################
  #####.....................#####
  #####.....................#####
  #####..B.......P.......N..#####
  #####.....................#####
  #####.....................#####
  #####.....................#####
  #####.....................#####
  #####..........+..........#####
  #####..........@..........#####
  #####.....................#####
  #####..D.....@.&.@.....T..#####
  #####.....................#####
  #####..........@..........#####
  #####..........=..........#####
  #####.....................#####
  #####.....................#####
  #####.....................#####
  #####.....................#####
  #####..F.......H.......R..#####
  #####.....................#####
  #####.....................#####
  ###############################
  ###############################
  ###############################
  ###############################
  ###############################
char_to_name_map:
  "#": wall
  ".": empty
  "B": carbon_extractor
  "P": chest_oxygen
  "N": oxygen_extractor
  "+": charger
  "@": agent.agent
  "D": chest_carbon
  "&": assembler
  "T": chest_silicon
  "=": chest
  "F": germanium_extractor
  "H": chest_germanium
  "R": silicon_extractor
