#####
#C..#
#.@.#
#..c#
#####
#####
#C..#
#.@.#
#..c#
#####
#####
#C..#
#.@.#
#..c#
#####
#####
#C..#
#.@.#
#..c#
#####
#####
#C..#
#.@.#
#..c#
#####
#####
#C..#
#.@.#
#..c#
#####
#####
#C..#
#.@.#
#..c#
#####
#####
#C..#
#.@.#
#..c#
#####
#####
#C..#
#.@.#
#..c#
#####
#####
#C..#
#.@.#
#..c#
#####
#####
#C..#
#.@.#
#..c#
#####
#####
#C..#
#.@.#
#..c#
#####