WWWWWWWWWWWWWWWWWWWWWWWWWWWWWWWWWWWWWWWW
W                                      W
W                                      W
W                                      W
W      WWWWWWW                         W
W         m                            W
W      WWWWWWW                         W
W                                      W
W                                      W
W              A             W W       W
W                            W W       W
W                            WnW       W
W                            W W       W
W                            W W       W
W                                      W
W                                      W
W             W W                      W
W             WaW                      W
W             W W                      W
W                                      W
WWWWWWWWWWWWWWWWWWWWWWWWWWWWWWWWWWWWWWWW