WWWWWWWWWWWWWWWWWWWWWWWWWWWWWWWWWWW
W                                 W
W         WWWWWWWWWW              W
W         W    m   W              W
W         W        W   A          W
W         W        W              W
W         WWWWWWW  W              W
W                                 W
W                                 W
W                       WW WWWWW  W
W                       W      W  W
W                       W  n   W  W
W                       W      W  W
W                       W      W  W
W                       WWWWWWWW  W
W    WWWWWWW                      W
W    W a   W                      W
W    W     W                      W
W    W     W                      W
W    W     W                      W
W    WWWW  W                      W
W                                 W
W                                 W
W                                 W
WWWWWWWWWWWWWWWWWWWWWWWWWWWWWWWWWWW
