####################
#..................#
#..................#
#........a.........#
#..................#
#..................#
#..................#
####............####
#..................#
#......#....#......#
#......#....#......#
#......#....#......#
#......#....#......#
#......#....#......#
#......#....#......#
#......#....#......#
#......#....#......#
#......#....#......#
#......#....#......#
#......#....#......#
#......#....#......#
#....m.#..@.#..n...#
####################