WWWWWWWWWWWWWWWWWWWW
W                  W
W                  W
W        a         W
W                  W
W                  W
W                  W
WWWW            WWWW
W                  W
W      W    W      W
W      W    W      W
W      W    W      W
W      W    W      W
W      W    W      W
W      W    W      W
W      W    W      W
W      W    W      W
W      W    W      W
W      W    W      W
W      W    W      W
W      W    W      W
W    m W  A W  n   W
WWWWWWWWWWWWWWWWWWWW