WWWWWWWWWWWWWWWWWWWWWWWWWWWW
W  A  m       W            W
W          WWWWWWWWWWWWWWWWW
W            W             W
W W  WWWWW      W        W W
W     W         W          W
W           WWWWWWW        W
W    W        W            W
W   WWWWW          WWWWW   W
W           W              W
W WWW       W     W        W
W     W           W        W
W   WWWW         WWWWWW WW W
W     W    W       W       W
W     W            W       W
W          W    WWWW       W
W      WWWW     W          W
WWWW                W      W
W       W           W      W
W       W         WWWWWW   W
W   WWWWW                  W
W                  W       W
WWWWWW          WWW W      W
W         W     WWW W      W
W         W                W
WW    n     W              W
W W                 a      W
W  W                       W
W   W                      W
WWWWWWWWWWWWWWWWWWWWWWWWWWWW
