############################
#..@..a.......#............#
#..........#################
#............#.............#
#.#..#####......#........#.#
#.....#.........#..........#
#...........#######........#
#....#........#............#
#...#####..........#####...#
#...........#..............#
#.###.......#.....#........#
#.....#...........#........#
#...####.........######.##.#
#.....#....#.......#.......#
#.....#............#.......#
#..........#....####.......#
#......####.....#..........#
####................#......#
#.......#...........#......#
#.......#.........######...#
#...#####..................#
#..................#.......#
######..........###.#......#
#.........#.....###.#......#
#.........#................#
##....m.....#..............#
#.#.................n......#
#..#.......................#
#...#......................#
############################