WWWWWWWWWWWWWWWWWWWWWW
n   WWWWW   WWW    m W
WW     WWW  WW    WWWW
WWWW    WW  W    WWWWW
WWWWW          WWWWWWW
W        A           W
WWWWWWW        WWWWWWW
WWWWW    W  W     WWWW
WWW     WW  WWWW    WW
W    WWWWW  WWWWWW aWW
WWWWWWWWWWWWWWWWWWWWWW