####################
#......#....####.a.#
##.....#....###...##
###....#....##...###
####...#....#...####
#####..........#####
######........######
#..................#
#........@.........#
#..................#
#..................#
######........######
#..................#
#......#....#......#
#......#....#......#
#......#....#......#
#......#....#......#
#..m...#....#..n...#
####################