WWWWWWWWWWWWWWWWWWWW
W      W    WWWW a W
WW     W    WWW   WW
WWW    W    WW   WWW
WWWW   W    W   WWWW
WWWWW          WWWWW
WWWWWW        WWWWWW
W                  W
W        A         W
W                  W
W                  W
WWWWWW        WWWWWW
W                  W
W      W    W      W
W      W    W      W
W      W    W      W
W      W    W      W
W  m   W    W  n   W
WWWWWWWWWWWWWWWWWWWW