#######################################################################
#......#......#......#......#......#......#......#......#......#......#
#......#......#.............#......#......#......#......#......#......#
#..@........................#......#......#......#......#......#......#
#....................#......#......#......#......#......#......#......#
#......#......#......#......#......#......#......#......#......#......#
###..###################...############################################
#......#.............#......#.............#......#......#.............#
#......#.............#......#.............#......#....................#
#.............#......#.............#..n...#...........................#
#.............#....................#......#.............#.............#
#......#......#......#......#......#.............#......#.............#
#####..###.#####..#######..####.########.####.########.###..........a.#
#......#......#......#......#......#.............#......#.............#
#.............#.............#......#.............#....................#
#.............#......#..m.................#......#....................#
#......#.............#......#.............#.............#.............#
#......#.............#......#......#......#.............#.............#
#######################################################################