WWWWWWWWWWWWWWWWWWWWWWWWWWWWWWWWW
W                W              W
W                W              W
W                W              W
W                W              W
W     WWW        W              W
W       W        W      W       W
W       W        W      W       W
W   a   W        W m    W       W
WWWWWWWWW        WWWWWWWW       W
W                               W
W                               W
W       A                       W
W                      WWWWWWWWWW
W                      W n      W
W                      W        W
W                               W
W            W                  W
WWWWWWWWWWWWWWWWWWWWWWWWWWWWWWWWW