##############################
#.@..........................#
################.............#
#............................#
#............................#
#............................#
#.........####################
#............................#
#............................#
#............................#
###################..........#
#............................#
#............................#
#............................#
#....a.....###################
#............................#
#............................#
#............................#
##############...............#
#............................#
#............................#
#............................#
#...........##################
#....a.......................#
#............................#
#............................#
#################............#
#............................#
#............................#
#............................#
##############################