##############################
#.@..........................#
################.............#
#............................#
#............................#
#............................#
#.........####################
#............................#
#............................#
#............................#
###################..........#
#............................#
#............................#
#............................#
#...._.....###################
#............................#
#............................#
#............................#
##############...............#
#............................#
#............................#
#............................#
#...........##################
#...._.......................#
#............................#
#............................#
#################............#
#............................#
#............................#
#............................#
##############################
