WWWWWWWWWWWWWWWWWWWWWWWWWWWWWW
W A                          W
WWWWWWWWWWWWWWWW             W
W                            W
W                            W
W                            W
W         WWWWWWWWWWWWWWWWWWWW
W                            W
W                            W
W                            W
WWWWWWWWWWWWWWWWWWW          W
W                            W
W                            W
W                            W
W    m     WWWWWWWWWWWWWWWWWWW
W                            W
W                            W
W                            W
WWWWWWWWWWWWWW               W
W                            W
W                            W
W                            W
W           WWWWWWWWWWWWWWWWWW
W    n                       W
W                            W
W                            W
WWWWWWWWWWWWWWWWW            W
W                            W
W                        a   W
W                            W
WWWWWWWWWWWWWWWWWWWWWWWWWWWWWW
