WWWWWWWWWWWWWWWWWW
W       W        W
Wr    A R A     aW
W       W        W
WWWWWWWWWWWWWWWWWW