WWWWWWWWWWWWWWWWWWWWWWWWW
Wr          a          bW
W                       W
W                       W
W                       W
W                       W
W                       W
W                       W
W                       W
W                       W
W                       W
W                       W
W          1 1          W
W                       W
W                       W
W                       W
W                       W
W                       W
W                       W
W                       W
W                       W
W                       W
W                       W
W          R B          W
WWWWWWWWWWWWWWWWWWWWWWWWW
WWWWWWWWWWWWWWWWWWWWWWWWW
WWWWWWWWWWWWWWWWWWWWWWWWW
WWWWWWWWWWWWWWWWWWWWWWWWW
WWWWWWWWWWWWWWWWWWWWWWWWW
Wr          a          bW
W                       W
W                       W
W                       W
W                       W
W                       W
W                       W
W                       W
W                       W
W                       W
W                       W
W                       W
W                       W
W                       W
W                       W
W                       W
W                       W
W                       W
W                       W
W                       W
W                       W
W                       W
W          R B          W
WWWWWWWWWWWWWWWWWWWWWWWWW