WWWWWWWWWWWWWWWWWWWWWWWWWWWWWWWWWWWWWWWWWWWWWWWWWWWWWWWWWWWWWWWWWWWWWWWW
W                                                                      W
W                                                                      W
W                                  W                                   W
W                                  W                                   W
W                                  W                                   W
W                                m nA                                  W
W                             WWWWaWWWWW                               W
W                                 nWm                                  W
W                                  W                                   W
W                                  W                                   W
W                                  W                                   W
W                                                                      W
WWWWWWWWWWWWWWWWWWWWWWWWWWWWWWWWWWWWWWWWWWWWWWWWWWWWWWWWWWWWWWWWWWWWWWWW
