WWWWWWWWWWWWWWWWWWWWWWWWWWWWWWWW
W            m                 W
W                              W
W   WWWWWWWWWWWWWWWWWWWWWWWW   W
W   W                      W   W
W   W   WWWWWW WWWWWWWWW   W   W
W   W   W              W   W  bW
W   W   W  WWWWWWWWW   W   W   W
W   W   W  W  A    W   W   W   W
W   W   W  W       W   W   W   W
W   W   W  W       W   W       W
W   W   W  W           W   W   W
W   W   W  WWWWWWWWW   W   W  aW
W   W   W              W   W   W
W   W   WWWWWWWWWWWWWWWW   W   W
W   W                      W   W
W   WWWWWWWWWWWWWWWWWWWWWWWW   W
W                              W
WWWWWWWWWWWWWWWWWWWWWWWWWWWWWWWW