WWWWWWWWWWWWWWWWWWWWWWWWWWWWWWWWWW
W           W                    W
W   W   W   W                    W
W   W   W   W                    W
W   W   W   W                    W
W   W   W   W                    W
WWWWW   W   W                    W
W   W   W   W                    W
W   W   W   W                    W
W   W   W   W                    W
W n W   W n W                    W
WWWWW   WWWWWWWWWWWWWWWWWWWWWWWWWW
W                                W
W                      A         W
W                                W
W                                W
WWWWW   WWWWWWWWWWWWWW   WWWWWWWWW
W a W   W a W     W m W   W m W  W
W   W   W   W     W   W   W   W  W
W   W   W   W     W   W   W   W  W
W   W   W   W     W   W   W   W  W
WWWWW   W   W     WmmmW   W   W  W
W   W   W   W     W   W   W   W  W
W   W   W   W     W   W   W   W  W
W   W   W   W     W   W   W  WW  W
W   W   W   W     W   W   W   W  W
W   W   W   W     W   W   W   W  W
W   W   W   W     W   W   W   W  W
W           W     W           W  W
WWWWWWWWWWWWWWWWWWWWWWWWWWWWWWWWWW