WWWWWWWWWWWWWWWWWWWWWWWWWWWWWWWW
W            m                 W
W                              W
W   WWWWWWWWWWWWWWWWWWWWWWWW   W
W   W                      W   W
W   W                      W   W
W   W      WWWWWWWWW       W  nW
W   W      W               W   W
W   W      W               W   W
W   W      W A        WWWWWW   W
W   W      WWWWWWWWWWWWW       W
W   W      W               W   W
W   W      W               W  aW
W   W      WWWWWWWWWWW     W   W
W   W                      W   W
W   W                      W   W
W   WWWWWWWWWWWWWWWWWWWWWWWW   W
W                              W
WWWWWWWWWWWWWWWWWWWWWWWWWWWWWWWW
