##############
##############
##############
##############
##############
##...........#
##...........#
##...........#
##...#...#...#
##...#...#...#
##...#...#...#
##...#...#...#
##...#...#...#
##...#...#...#
##...#.@.#___#
##############
##############
##############
##############
##############
##...........#
##...........#
##...........#
##...#...#...#
##...#...#...#
##...#...#...#
##...#...#...#
##...#...#...#
##...#...#...#
##...#...#...#
##___#.@.#...#
##############
##############
##############