WWWWWWWWWWWWWW
WWWWWWWWWWWWWW
WWWWWWWWWWWWWW
WWWWWWWWWWWWWW
WWWWWWWWWWWWWW
WW           W
WW           W
WW           W
WW   W   W   W
WW   W   W   W
WW   W   W   W
WW   W   W   W
WW   W   W   W
WW   W   W   W
WW   W A WaaaW
WWWWWWWWWWWWWW
WWWWWWWWWWWWWW
WWWWWWWWWWWWWW
WWWWWWWWWWWWWW
WWWWWWWWWWWWWW
WW           W
WW           W
WW           W
WW   W   W   W
WW   W   W   W
WW   W   W   W
WW   W   W   W
WW   W   W   W
WW   W   W   W
WW   W   W   W
WWaaaW A W   W
WWWWWWWWWWWWWW
WWWWWWWWWWWWWW
WWWWWWWWWWWWWW