WWWWWWWWWWWWWW
WWWWWWWWWWWWWW
WWWWWWWWWWWWWW
WWWWWWWWWWWWWW
WWWWWWWWWWWWWW
WW           W
WW           W
WW           W
WW   W   W   W
WW   W   W   W
WW   W   W   W
WW   W   W   W
WW   W   W   W
WW   W   W   W
WW n W AaWm  W
WWWWWWWWWWWWWW
WWWWWWWWWWWWWW
WWWWWWWWWWWWWW
WWWWWWWWWWWWWW
WWWWWWWWWWWWWW
WW           W
WW           W
WW           W
WW   W   W   W
WW   W   W   W
WW   W   W   W
WW   W   W   W
WW   W   W   W
WW   W   W   W
WW   W   W   W
WW  mWaA Wn  W
WWWWWWWWWWWWWW
WWWWWWWWWWWWWW
WWWWWWWWWWWWWW