WWWWWWWWWWWWW
WWWWWWWWWWWWW
WWWWWWWWWWWWW
WWWWWWWWWWWWW
W           W
W           W
W           W
W   W   W   W
W   W   W   W
W   W   W   W
W   W   W   W
W   W   W   W
W   W   W   W
W   W   W   W
W   W   W   W
W   W   W   W
W   W   W   W
W   W   W   W
W   W   W   W
W   W   W   W
W   W   W   W
W   W   W   W
W   W   W   W
W   W   W   W
W   W   W   W
W   W   W   W
W   W   W   W
W   W   W   W
W  nW AaWm  W
WWWWWWWWWWWWW
WWWWWWWWWWWWW
WWWWWWWWWWWWW
WWWWWWWWWWWWW
WWWWWWWWWWWWW
W           W
W           W
W           W
W   W   W   W
W   W   W   W
W   W   W   W
W   W   W   W
W   W   W   W
W   W   W   W
W   W   W   W
W   W   W   W
W   W   W   W
W   W   W   W
W   W   W   W
W   W   W   W
W   W   W   W
W   W   W   W
W   W   W   W
W   W   W   W
W   W   W   W
W   W   W   W
W   W   W   W
W   W   W   W
W   W   W   W
W  mWaA Wn  W
WWWWWWWWWWWWW
WWWWWWWWWWWWW
WWWWWWWWWWWWW
WWWWWWWWWWWWW
WWWWWWWWWWWWW
WWWWWWWWWWWWW