#############
#############
#############
#############
#...........#
#...........#
#...........#
#...#...#...#
#...#...#...#
#...#...#...#
#...#...#...#
#...#...#...#
#...#...#...#
#...#...#...#
#...#...#...#
#...#...#...#
#...#...#...#
#...#...#...#
#...#...#...#
#...#...#...#
#...#...#...#
#...#...#...#
#...#...#...#
#...#...#...#
#...#...#...#
#...#...#...#
#...#...#...#
#...#...#...#
#...#.@.#aaa#
#############
#############
#############
#############
#############
#...........#
#...........#
#...........#
#...#...#...#
#...#...#...#
#...#...#...#
#...#...#...#
#...#...#...#
#...#...#...#
#...#...#...#
#...#...#...#
#...#...#...#
#...#...#...#
#...#...#...#
#...#...#...#
#...#...#...#
#...#...#...#
#...#...#...#
#...#...#...#
#...#...#...#
#...#...#...#
#...#...#...#
#...#...#...#
#...#...#...#
#aaa#.@.#...#
#############
#############
#############
#############
#############
#############