#############
#############
#############
#############
#...........#
#...........#
#...........#
#...#...#...#
#...#...#...#
#...#...#...#
#...#...#...#
#...#...#...#
#...#...#...#
#...#...#...#
#...#...#...#
#...#...#...#
#...#...#...#
#...#...#...#
#...#...#...#
#...#...#...#
#...#...#...#
#...#...#...#
#...#...#...#
#...#...#...#
#...#...#...#
#...#...#...#
#...#...#...#
#...#...#...#
#..n#.@a#m..#
#############
#############
#############
#############
#############
#...........#
#...........#
#...........#
#...#...#...#
#...#...#...#
#...#...#...#
#...#...#...#
#...#...#...#
#...#...#...#
#...#...#...#
#...#...#...#
#...#...#...#
#...#...#...#
#...#...#...#
#...#...#...#
#...#...#...#
#...#...#...#
#...#...#...#
#...#...#...#
#...#...#...#
#...#...#...#
#...#...#...#
#...#...#...#
#...#...#...#
#..m#a@.#n..#
#############
#############
#############
#############
#############
#############