WWWWWWWWWWWWWWWWWWWWWWWWWWWW
W                          W
W   A a                    W
WWWWWWWWWWWWWWW            W
W                          W
W  n                       W
WWWWWWWWWWWWWWW            W
W             W            W
W       WWWWWWWWWWWWWW     W
W             W            W
W             W            W
W             W            W
W             W            W
W                          W
W                          W
W                          W
W                          W
W      WWWWWWWWWWWW        W
W                          W
W                          W
W             W            W
W             W            W
WWWWWWWWW          WWWWWWWWW
W                          W
W                          W
W                          W
W       m     W            W
W             W            W
W             W            W
W             W            W
W             W            W
WWWWWWWWWWWWWWWWWWWWWWWWWWWW