################
#..#a@#..#..#..#
#..#..#..#..#..#
#..#..#..#..#..#
#..#..#..#..#..#
#..#..#..#..#..#
#..#..#..#..#..#
#..#.##..#..#..#
#..............#
#..............#
#..............#
#...m.....n....#
#..............#
#..............#
################