WWWWWWWWWWWWWWWW
W  WaAW  W  W  W
W  W  W  W  W  W
W  W  W  W  W  W
W  W  W  W  W  W
W  W  W  W  W  W
W  W  W  W  W  W
W  W  W  W  W  W
W  W  W  W  W  W
W  W  W  W  W  W
W  W  W  W  W  W
W  W  W  W  W  W
W  W WW  W  W  W
W              W
W              W
W              W
W   m     n    W
W              W
W              W
WWWWWWWWWWWWWWWW