WWWWWWWWWWWWWWWWWW
W                W
W    A           W
W                W
WWWWWW     WWWWWWW
W    W     W a   W
W    W     W     W
W    W     W     W
W    W     W     W
W    W     W     W
W    W     W     W
W    W     W     W
W    W     W     W
W    W     W     W
W    W     WW    W
W                W
W                W
W                W
WWWWWW     WWWWWWW
W  g W     W     W
W    W     W     W
W    W     W     W
W    W     W     W
W    W     W     W
W    W     W     W
W    W     W     W
W    W     W     W
W    W     W     W
W   WW     W     W
W                W
W                W
W                W
WWWWWW     WWWWWWW
W    W     W m   W
W    W     W     W
W    W     W     W
W    W     W     W
W    W     W     W
W    W     W     W
W    W     W     W
W    W     W     W
W    W     W     W
W    W     WW    W
W                W
W                W
W                W
WWWWWWWWWWWWWWWWWW