##############
##############
##############
##############
##############
##...........#
##...........#
##...........#
##...#...#...#
##...#...#...#
##...#...#...#
##...#...#...#
##...#...#...#
##...#...#...#
##...#...#...#
##...#...#...#
##...#...#...#
##...#...#...#
##...#...#...#
##...#.@.#aaa#
##############
##############
##############
##############
##############
##...........#
##...........#
##...........#
##...#...#...#
##...#...#...#
##...#...#...#
##...#...#...#
##...#...#...#
##...#...#...#
##...#...#...#
##...#...#...#
##...#...#...#
##...#...#...#
##...#...#...#
##aaa#.@.#...#
##############
##############
##############