WWWWWWWWWWWWWW
WWWWWWWWWWWWWW
WWWWWWWWWWWWWW
WWWWWWWWWWWWWW
WWWWWWWWWWWWWW
WW           W
WW           W
WW           W
WW   W   W   W
WW   W   W   W
WW   W   W   W
WW   W   W   W
WW   W   W   W
WW   W   W   W
WW   W   W   W
WW   W   W   W
WW   W   W   W
WW   W   W   W
WW   W   W   W
WW  nWAa W m W
WWWWWWWWWWWWWW
WWWWWWWWWWWWWW
WWWWWWWWWWWWWW
WWWWWWWWWWWWWW
WWWWWWWWWWWWWW
WW           W
WW           W
WW           W
WW   W   W   W
WW   W   W   W
WW   W   W   W
WW   W   W   W
WW   W   W   W
WW   W   W   W
WW   W   W   W
WW   W   W   W
WW   W   W   W
WW   W   W   W
WW   W   W   W
WW  mWaA W n W
WWWWWWWWWWWWWW
WWWWWWWWWWWWWW
WWWWWWWWWWWWWW