#################################
#..........#....................#
#...#...#..#....................#
#...#...#..#....................#
#...#...#..#....................#
#...#...#..#....................#
#.n.#...#..#....................#
#####...#########################
#...............................#
#......................@........#
#...............................#
#...............................#
#####...##############...########
#.a.#...#..#.....#...#...#.m.#..#
#...#...#..#.....#...#...#...#..#
#...#...#..#.....#...#...#...#..#
#...#...#..#.....#...#...#...#..#
#...#...#..#.....#...#...#...#..#
#...#...#..#.....#...#...#...#..#
#..........#.....#...........#..#
#################################