WWWWWWWWWWWWWWWWWWWWWWWWWWWWWWWWW
W          W                    W
W   W   W  W                    W
W   W   W  W                    W
W   W   W  W                    W
W   W   W  W                    W
W n W   W  W                    W
WWWWW   WWWWWWWWWWWWWWWWWWWWWWWWW
W                               W
W                      A        W
W                               W
W                               W
WWWWW   WWWWWWWWWWWWWW   WWWWWWWW
W a W   W  W     W   W   W m W  W
W   W   W  W     W   W   W   W  W
W   W   W  W     W   W   W   W  W
W   W   W  W     W   W   W   W  W
W   W   W  W     W   W   W   W  W
W   W   W  W     W   W   W   W  W
W          W     W           W  W
WWWWWWWWWWWWWWWWWWWWWWWWWWWWWWWWW