
WWWWWWWWWWWWWWWWWWWWWWWWW
Wn                      W
W                       W
W                       W
W   W    W    W    W    W
W   W    W    W    W    W
W   W    W    W    W    W
W   W    W    W    W    W
W   W    W    W    W    W
W   W    W    W    W    W
W   W    W    W    W    W
W   W  a W  A W    W m  W
WWWWWWWWWWWWWWWWWWWWWWWWW
WWWWWWWWWWWWWWWWWWWWWWWWW
WWWWWWWWWWWWWWWWWWWWWWWWW
WWWWWWWWWWWWWWWWWWWWWWWWW