WWWWWWWWWWWWWWWWWWWWWWWWWWWWWWWWWWWWWWWWWWWWWWWWWWWWWWWWWWWWWWWWWWWWWWWWWWWWWWWWWWWWWWWWWWWWWWWWWWWWWWWWWWWWWWWWWWWWWWWWWW
WWWWWWWWWWWWW  WWWWWWWWWWWWWWWWWWWWWWWWWWWWWWWWWWWWWWWWWWWWW  WWWWWWWWWWWWW  WWWWWWWWWWWWWWWWWWWWWWWWWWWWWWWWWWWWWWWWWWWWW
WWWWWWWWWWWWW  WWa                WWWWW                 WWWW  WWWWWWWWWWWWW  WWWW                aWWWWW                 WW
WWWWWWWWWWWWW  WWa                WWWWW                 WWWW  W   W A WaaaW  WWWW                aWWWWW                 WW
WWWWWWWWWWWWW  WWa                WWWWW                 WWWW  W   W   W   W  WWWW                aWWWWW                 WW
W           W  WWWWWWWWWWWWWWWW   WWWWWWWWWWWWWWWWWWW   WWWW  W   W   W   W  WWWW   WWWWWWWWWWWWWWWWWWW   WWWWWWWWWWWWWWWW
W           W  WW                 WWWWW                 WWWW  W   W   W   W  WWWW                 WWWWW                 WW
W           W  WWA                WWWWWA                WWWW  W   W   W   W  WWWW                AWWWWW                AWW
W   W   W   W  WW                 WWWWW                 WWWW  W   W   W   W  WWWW                 WWWWW                 WW
W   W   W   W  WWWWWWWWWWWWWWWW   WWWWWWWWWWWWWWWWWWW   WWWW  W   W   W   W  WWWW   WWWWWWWWWWWWWWWWWWW   WWWWWWWWWWWWWWWW
W   W   W   W  WW                 WWWWWa                WWWW  W   W   W   W  WWWW                 WWWWW                aWW
W   W   W   W  WW                 WWWWWa                WWWW  W   W   W   W  WWWW                 WWWWW                aWW
W   W   W   W  WW                 WWWWWa                WWWW  W   W   W   W  WWWW                 WWWWW                aWW
W   W   W   W  WWWWWWWWWWWWWWWWWWWWWWWWWWWWWWWWWWWWWWWWWWWWW  W   W   W   W  WWWWWWWWWWWWWWWWWWWWWWWWWWWWWWWWWWWWWWWWWWWWW
W   W   W   W                                                 W   W   W   W                                              W
W   W   W   W                                                 W   W   W   W                                              W
W   W   W   W                                                 W   W   W   W                                              W
W   W   W   W                                                 W           W                                              W
W   W   W   W                                                 W           W                                              W
W   W   W   W                                                 W           W                                              W
W   W   W   W                                                 W           W                                              W
W   W A WaaaW                                                 WWWWWWWWWWWWW                                              W
WWWWWWWWWWWWW                                                 WWWWWWWWWWWWW                                              W
WWWWWWWWWWWWW                                                 WWWWWWWWWWWWW                                              W
WWWWWWWWWWWWW                                                 WWWWWWWWWWWWW                                              W
WWWWWWWWWWWWW                                                 WWWWWWWWWWWWW                                              W
WWWWWWWWWWWWW                                                 WWWWWWWWWWWWW                                              W
W           W                                                 WaaaW A W   W                                              W
W           W                                                 W   W   W   W                                              W
W           W                                                 W   W   W   W                                              W
W   W   W   W                                                 W   W   W   W                                              W
W   W   W   W                                                 W   W   W   W                                              W
W   W   W   W                                                 W   W   W   W                                              W
W   W   W   W                                                 W   W   W   W                                              W
W   W   W   W                                                 W   W   W   W                                              W
W   W   W   W                                                 W   W   W   W                                              W
W   W   W   W                                                 W   W   W   W                                              W
W   W   W   W                                                 W   W   W   W                                              W
W   W   W   W                                                 W   W   W   W                                              W
W   W   W   W                                                 W   W   W   W                                              W
W   W   W   W                                                 W   W   W   W                                              W
W   W   W   W                                                 W   W   W   W                                              W
W   W   W   W                                                 W   W   W   W                                              W
WaaaW A W   W                                                 W           W                                              W
WWWWWWWWWWWWW                                                 W           W                                              W
WWWWWWWWWWWWW                                                 W           W                                              W
WWWWWWWWWWWWW                                                 WWWWWWWWWWWWW                                              W
WWWWWWWWWWWWW                                                 WWWWWWWWWWWWW                                              W
WWWWWWWWWWWWW                                                 WWWWWWWWWWWWW                                              W
WWWWWWWWWWWWW                                                 WWWWWWWWWWWWW                                              W
WWWWWWWWWWWWW                                                 WWWWWWWWWWWWW                                              W
WWWWWWWWWWWWWWWWWWWWWWWWWWWWWWWWWWWWWWWWWWWWWWWWWWWWWWWWWWWWWWWWWWWWWWWWWWWWWWWWWWWWWWWWWWWWWWWWWWWWWWWWWWWWWWWWWWWWWWWWWW
