WWWWWWWWWWWWWWWWWWWWWWWWWWWWWW
WWWWWWWWWWWWWWWWWWWWWWWWWWWWWW
W                            W
Waaa                         W
WWWWWWWWWW                   W
W         W   W              W
W   A     W   W              W
W         W   W              W
W         W   W              W
W             W              W
W             W              W
WWWWWWWWWWWWWWWWWWWWWWWWWWWWWW