WWWWWWWWWWWWWWWWWWWWWWWWWWWW
W                     WA  aW
W                     W    W
W                     W    W
W                     W    W
W                     W    W
W                     W    W
W                          W
W                          W
W                     W    W
W                     W    W
W                     W    W
W                     W    W
W                     W    W
W      WWWWWWWWWWW    WWWWWW
W      Wn                  W
W      W                   W
W      WWWWWWWWWWWWWWWWWWWWW
W                          W
W                          W
W                          W
W                          W
WWWWWWWWW          WWWWWWWWW
W                          W
W                          W
W                          W
W       m                  W
W                          W
W                          W
W                          W
W                          W
WWWWWWWWWWWWWWWWWWWWWWWWWWWW