WWWWWWWWWWWWWWW
W             W
W             W
W    W        W
W    W        W
Waaa W        W
WWWWWW        W
W      A      W
W        WWWWWW
W        W a  W
W        W    W
W        W    W
W             W
W             W
WWWWWWWWWWWWWWW
WWWWWWWWWWWWWWW
WWWWWWWWWWWWWWW
WWWWWWWWWWWWWWW
WWWWWWWWWWWWWWW
WWWWWWWWWWWWWWW
WWWWWWWWWWWWWWW
W             W
W             W
W    W        W
W    W        W
W  a W        W
WWWWWW        W
W      A      W
W        WWWWWW
W        Waaa W
W        W    W
W        W    W
W             W
W             W
WWWWWWWWWWWWWWW