WWWWWWWWWWWWWWWWWWWWWWWWWWWWWWWWW
W                               W
W                          A    W
W                               W
W                               W
W     WWWWWWWWWWWWWWWWWWWWWWWWWWW
W     W n    W   W           m  W
W     W      W   W              W
W     W      W   W              W
W     W      W   W              W
Wa    W      W   W              W
W     W      W   W              W
W     W      W   W              W
W     W      W   W              W
W     W      W   W              W
W     W      W   W              W
W     W      W   W              W
W     W      W   W              W
W     W      W   W              W
W WWWWW      WWWWW              W
W                               W
W                               W
W                               W
W                               W
WWWWWWWWWWWWWWWWWWWWWWWWWWWWWWWWW