WWWWWWWWWWWWWWWWWWWWWWWWWWWWWWWWWWWWWWWWWWWWWWWWWWWWWWWWWWWWWWWWWWWWWWWW
W                                                                      W
W                                                                      W
W     WWWWWWWWWWWWWWWWWWWWWWWWWWWWWWWWWWWWWWWWWWWWWWWWWWWWWWWWWWWWWWWWWW
W     W                                                                W
W     W                                                                W
W     W                                                                W
W     W                                                                W
W     W                                                                W
W     W                                                                W
W     W                                                                W
W     W                                                                W
W     W                                                                W
W     W                                                                W
W     W                                                                W
W     W                                                                W
W     W                                                                W
W     W                                                                W
W     W                                                                W
W     W                                                                W
W     W                                                                W
W     W                                                                W
W     W                                                                W
W     W                                                                W
W     W                                                                W
W     W                                                                W
W     W g                                                              W
W     W                                                                W
W     W                                                                W
W     W                                                                W
W     W                                                                W
W     W                                                                W
W     W                                                                W
W     W                                                                W
W     W                                                                W
W     W                                                                W
W     W                                                                W
W     W               m                                                W
W     W                                                                W
W     WWWWWWWWWWWWWWWWWWWWWWWWWWWWWWWWWWWWWWWWWWWWWWWWWWWWWWWWWW     a W
W                                                                      W
W                                                                      W
W                                                                      W
WWWWWWWWWWWWWWWWWWWWWWWWWWWWWWWWWWWWWWWWWWWWWWWWWWWWWWWWWWWWWWWWWWWWWWWW