WWWWWWWWWWW
W       WmW
W WWW  W  W
W W    W  W
W W a  W  W
W W  A W  W
W W    W  W
W W WWWW  W
WgW       W
WWWWWWWWWWW
