##################
#.......@........#
#................#
#................#
######.....#######
#..a.#.....#..n..#
#....#.....#.....#
#....#.....#.....#
#....#.....#.....#
#.n..#.....#.....#
#....#.....#.a...#
#....#.....#.....#
#..m.#.....#.m...#
#....#.....#.....#
#....#.....#######
#....#.....#.....#
#....#.....#.....#
#....#.....#.....#
#....#.....#.....#
#....#.....#.....#
#....#.....#.....#
#....#.....#.....#
#....#.....#.....#
#....#.....#.....#
#....#.....#.....#
#....#.....#.....#
#....#.....#.....#
#....#.....#.....#
#....#.....#.....#
#....#.....#.....#
#....#.....#.....#
#................#
#................#
#................#
##################