WWWWWWWWWWWWWWWWWW
W       A        W
W                W
W                W
WWWWWW     WWWWWWW
W  a W     W  n  W
W    W     W     W
W    W     W     W
W    W     W     W
W n  W     W     W
W    W     W a   W
W    W     W     W
W  m W     W m   W
W    W     W     W
W    W     WWWWWWW
W    W     W     W
W    W     W     W
W    W     W     W
W    W     W     W
W    W     W     W
W    W     W     W
W    W     W     W
W    W     W     W
W    W     W     W
W    W     W     W
W    W     W     W
W    W     W     W
W    W     W     W
W    W     W     W
W    W     W     W
W    W     W     W
W                W
W                W
W                W
WWWWWWWWWWWWWWWWWW
