############################
#..........................#
#...@......................#
#.............######.......#
#.............#............#
#.............#....B.......#
#.............#............#
#.............#............#
#.####.....................#
#....#.....................#
#..B.#.....................#
#..........................#
#..........................#
#..........................#
#..........................#
#..........................#
#..........................#
#........#####..###........#
#........#...B....#........#
#...........#..............#
#..........................#
#..........................#
############################
