WWWWWWWWWWWWWWWWWWWWW
W                   W
W                   W
W                   W
W                   W
W                   W
W           a       W
W     A             W
W           a       W
W                   W
W       a           W
W                   W
W                   W
W                   W
W                   W
WWWWWWWWWWWWWWWWWWWWW