WWWWWWWWWWWWWWWWWWWWW
W                   W
W                   W
W                   W
W                   W
W                   W
W           m       W
W     A             W
W           g       W
W                   W
W       a           W
W                   W
W                   W
W                   W
W                   W
WWWWWWWWWWWWWWWWWWWWW