WWWWWWWWWWWWWWWWWWWWWWWWWWWWWWWWWWWWWWWWWWWWWWWWWWWWWWWWWWWWWWWWWWWWWWW
W A                         W                                         W
W                           W                                         W
W                           W                                         W
W                           W                                         W
W                           W                    g                    W
WWWWWWWWWWWWWWW             WWWWWWWWWWWWWWW                           W
W             W             W                                        W
W             W             W                           W             W
W             W             W                           W             W
W             W             W                           W             W
W             W             W                           W             W
WWWWWWWWWWWWWWW             W                 WWWWWWWWWWW             W
W             W                                         W             W
W             W                          m              W             W
W             W                                         W             W
W             W                                         W    a        W
W             W                                         W             W
WWWWWWWWWWWWWWWWWWWWWWWWWWWWWWWWWWWWWWWWWWWWWWWWWWWWWWWWWWWWWWWWWWWWWWW