WWWWWWWWWWWWWWWWWWWWWW
W  a                 W
W                    W
W                    W
W                    W
W                    W
W                    W
W                    W
W                g   W
W                    W
W                    W
W                    W
W  A                 W
W                    W
W                    W
W                    W
W                    W
W                    W
W               m    W
WWWWWWWWWWWWWWWWWWWWWW
