WWWWWWWWWWWWWWWWWWWWWWWWW
WWWWWWWWWW  a  WWWWWWWWWW
WWWWWWWWWW     WWWWWWWWWW
WWWWWWWWWW     WWWWWWWWWW
WWWWWWWWWW     WWWWWWWWWW
WWWWWWWWWW     WWWWWWWWWW
WWWWWWWWWW     WWWWWWWWWW
WWWWWWWWWW     WWWWWWWWWW
WWWWWWWWWW     WWWWWWWWWW
WWWWWWWWWW     WWWWWWWWWW
W                       W
W                       W
Wa                     aW
W                       W
W                       W
WWWWWWWWWW     WWWWWWWWWW
WWWWWWWWWW     WWWWWWWWWW
WWWWWWWWWW     WWWWWWWWWW
WWWWWWWWWW     WWWWWWWWWW
WWWWWWWWWW     WWWWWWWWWW
WWWWWWWWWW     WWWWWWWWWW
WWWWWWWWWW     WWWWWWWWWW
WWWWWWWWWW     WWWWWWWWWW
WWWWWWWWWW  A  WWWWWWWWWW
WWWWWWWWWWWWWWWWWWWWWWWWW