WWWWWWWWWWWWWWWWWWWWWWWWW
W                       W
W                       W
W  g                    W
WWWWWWWWWWWWWWWW        W
W                       W
W                       W
W  A          WW        W
W  a           W        W
W              W        W
WWWWWWWWWWWWWWWW        W
WWWWWWWWWWWWWWWW        W
W                       W
W                       W
W                       W
WWWWWWWWWWWWWWWW        W
WWWWWWWWWWWWWWWW        W
WWWWWWWWWWWWWWWW  m     W
WWWWWWWWWWWWWWWW        W
WWWWWWWWWWWWWWWW        W
WWWWWWWWWWWWWWWW        W
WWWWWWWWWWWWWWWWWWWWWWWWW
