WWWWWWWWWWWWWWWWWWWWWWWWWWWWWWWWWWWWWWWWWWWWWWWWWWW
W                                                 W
W                                                 W
W                                                 W
W       g                                         W
W        A        m                               W
W                                                 W
W                                                 W
W                                                 W
W                                                 W
W                                                 W
W                                                 W
W                                                 W
W                                                 W
W                                                 W
W                                                 W
W                                                 W
W                                                 W
W                                                 W
W                                                 W
W                                                 W
W                                                 W
W                                                 W
W                                                 W
W                                                 W
W                                                 W
W                                                 W
W                                                 W
W                                                 W
W                                                 W
W                                                 W
W                                                 W
W                                                 W
W                                                 W
W                                                 W
W                                                 W
W                                                 W
W                                                 W
W                             a                   W
W                                                 W
W                                                 W
W                                                 W
W                                                 W
W                                                 W
W                                                 W
W                                                 W
W                                                 W
W                                                 W
W                                                 W
WWWWWWWWWWWWWWWWWWWWWWWWWWWWWWWWWWWWWWWWWWWWWWWWWWW