WWWWWWWWWWWWWWWWWWWWWWWWWWWWWWWWWWWWWWWWWWWWWWWWWW
W  ggggggcccccccgggggggcccccccggggggccccccggggg  W
W      A           A           A        A        W
Wc           A           A          A           cW
Wc     A           A           A         A      cW
W            A           A          A            W
W  c                      a                    g W
W      A           A           A         A       W
W c          A           A           A           W
W c    A           A           A          A    c W
W c          A           A          A          c W
W     gggggggggggggggggggcccccccccccccccccccccc  W
WWWWWWWWWWWWWWWWWWWWWWWWWWWWWWWWWWWWWWWWWWWWWWWWWW
WWWWWWWWWWWWWWWWWWWWWWWWWWWWWWWWWWWWWWWWWWWWWWWWWW
W  ggggggcccccccgggggggcccccccggggggccccccggggg  W
W      A           A           A        A        W
Wc           A           A          A           cW
Wc     A           A           A         A      cW
W            A           A          A            W
W  c                     a                     g W
W      A           A           A         A       W
W c          A           A           A           W
W c    A           A           A          A    c W
W c          A           A          A          c W
W     gggggggggggggggggggcccccccccccccccccccccc  W
WWWWWWWWWWWWWWWWWWWWWWWWWWWWWWWWWWWWWWWWWWWWWWWWWW