##################################################
#     g   g   g   g   g   g    g    g    g    g  #
#      A           A           A        A        #
#c                                              c#
#c                                              c#
#c           A           A          A           c#
#c                                              c#
#c     A           A           A         A      c#
#c                                              c#
#c                                              c#
#            A           A          A            #
#                                                #
#  c                                           g #
#  c                                           g #
#  c                                           g #
#  c                                           g #
#  c                    aaa                    g #
#  c                                           g #
#  c                                           g #
#  c                                           g #
#                                                #
#                                                #
#      A           A           A         A       #
#                                                #
#                                                #
#            A           A           A           #
# c                                            c #
# c    A           A           A          A    c #
# c                                            c #
# c                                            c #
# c          A           A          A          c #
# c                                            c #
# c                                            c #
#     g   g   g   g   g   g    g    g    g    g  #
#                                                #
##################################################