##################################################
#  ggggggcccccccgggggggcccccccggggggccccccggggg  #
#      A           A           A        A        #
#c           A           A          A           c#
#c     A           A           A         A      c#
#            A           A          A            #
#  c                      a                    g #
#      A           A           A         A       #
# c          A           A           A           #
# c    A           A           A          A    c #
# c          A           A          A          c #
#     gggggggggggggggggggcccccccccccccccccccccc  #
##################################################
##################################################
#  ggggggcccccccgggggggcccccccggggggccccccggggg  #
#      A           A           A        A        #
#c           A           A          A           c#
#c     A           A           A         A      c#
#            A           A          A            #
#  c                     a                     g #
#      A           A           A         A       #
# c          A           A           A           #
# c    A           A           A          A    c #
# c          A           A          A          c #
#     gggggggggggggggggggcccccccccccccccccccccc  #
##################################################