#############################################
#   c    g    c    g     c    g    c    g   #
#  g      A     A     A     A     A     A   #
#         g       g       g        g        #
#  g                                        #
#          A    A    A    A    A            #
#                                           #
#  c         c                 c            #
#                                           #
#                                           #
#  g                  #                     #
#                   a # a                   #
#                  #######                  #
#  g                a # a                   #
#                     #                     #
#                                           #
#  c                                        #
#  c                                        #
#  c                                        #
#        A   A    A    A    A      A        #
#  c                                    c   #
#          A     A     A     A     A        #
#  g     g    g    g      g     g    g    g #
#                    a                      #
#############################################