WWWWWWWWWWWWWWWWWWWWWWWWWWWWWWWWWWWWWWWWWWWWW
W  a                  c                 a   W
W    A                                 A    W
W  g                                    g   W
W                                           W
W                                           W
W                                           W
W g  A                                 A  a W
W                                           W
W                                           W
W                                           W
W  c                                    c   W
W    A                a                A    W
W  g                  a                 g   W
WWWWWWWWWWWWWWWWWWWWWWWWWWWWWWWWWWWWWWWWWWWWW