WWWWWWWWWWWWWWWWWWWWWWWWWWWWWWW
W                             W
W       a          c          W
W                             W
W           AAAAAAA           W
W     WWWWWWWWWWWWWWWWW       W
W             g               W
W     WWWWWWWWWWWWWWWWW       W
W                             W
W                             W
W                             W
WWWWWWWWWWWWWWWWWWWWWWWWWWWWWWW