###############################
#                             #
#       a          c          #
#                             #
#           AAAAAAA           #
#     #################       #
#             g               #
#     #################       #
#                             #
#                             #
#                             #
###############################