WWWWWWWWWWWWWWWWWWWWWWWWWWWWWWWWWWWWWWWW
WWWWWWWWWa A  WWWW     WWWW     WWWWWWWW
WWWWWWWWW     WWWW     WWWW     WWWWWWWW
WWWWWWWWW     WWWW     WWWW     WWWWWWWW
WWWWWWWWW     WWWW     WWWW     WWWWWWWW
WWWWWWWWW     WWWW     WWWW     WWWWWWWW
WWWWWWWWWL    WWWW     WWWW     WWWWWWWW
W                                      W
W                                      W
W                                      W
WWWWWWWWW                     WWWWWWWWWW
WWWWWWWWW                     WWWWWWWWWW
WWWWWWWWW                     WWWWWWWWWW
W                                      W
W                                      W
W                                      W
WWWWWWWWW      m              WWWWWWWWWWW
WWWWWWWWW                     WWWWWWWWWW
WWWWWWWWW                     WWWWWWWWWW
W                                      W
W                                      W
W                                      W
WWWWWWWWW                     WWWWWWWWWW
WWWWWWWWW                     WWWWWWWWWW
WWWWWWWWW                     WWWWWWWWWW 
W                      g               W
W                                      W
W                                      W
WWWWWWWWW     WWWW     WWWW     WWWWWWWW
WWWWWWWWW     WWWW     WWWW     WWWWWWWW
WWWWWWWWW     WWWW     WWWW     WWWWWWWW
WWWWWWWWW     WWWW     WWWW     WWWWWWWW
WWWWWWWWW     WWWW     WWWW     WWWWWWWW
WWWWWWWWW     WWWW     WWWW     WWWWWWWW
WWWWWWWWWWWWWWWWWWWWWWWWWWWWWWWWWWWWWWWW