WWWWWWWWWWWWWWWWWWWWWWWWWWWWWWWWWWW
W                                 W
W                                 W
W     A             WWWWWW        W
W                   W   mW        W
W                   W    W        W
W                   WWWWWW        W
W                        W        W
W              W     WWWWWW       W
W   WWWWWW                        W
W   W  g W                        W
W   WWWWWW                   WWWWWW
W                            W m  W
W                            W    W
W                             WWWWW
W       W                         W
W                                 W
W           WWWWWWWWWWWWWWWW      W
W           W              W      W
W           W              W      W
W           W      WWWW    W      W
W           WW     W       W      W
W                  W m g a W      W
W                  W       W      W
W                  WWWWWWWWW      W
W                                 W
W                                 W
W                                 W
W           W                     W
WWWWWWWWWWWWWWWWWWWWWWWWWWWWWWWWWWW