WWWWWWWWWWWWWWWWWWWWWWWWWWWWWWWWWWWWWWWW
Wm                                    AW
W    WWWWWWWWWWWWWWWWWWWWWWWWWWWWWWWWWWW
W    Wm                                W
W    W   WWWWWWWWWWWWWWWWWWWWWWWWWWW   W
W    W   Wm                       mW   W
W    W   W   WWWWWWWWWWWWWWWWWWW   W   W
W    W   W   W               m W   W   W
W    W   W   W   WWWWWWW       W   W   W
W    W   W   W   W     W   W   W   W   W
W    W   W   W   W  a  W   W   W   W  mW
W    W   W   W   W     W   W   W   W   W
W    W   W   W   W     W   W   W   W   W
W    W   W   W      g      W   W   W   W
W    W   W   WWWWWWWWWWWWWWW   W   W   W
W    W   W m                 m W   W   W
W    W   WWWWWWWWW   WWWWWWWWWWW   W  mW
W    Wm          W   W            mW   W
W    WWWWWWWWW   W   W   WWWWWWWWWWW   W
Wm         m W   W   W   Wm            W
WWWWWWWWW    W   W   W   W   WWWWWWWWWWW
W       W    W   W   W   W   W      W  W
W   W   W    W   W   W  mW   W   W  W  W
W   W   W    W   W   W   W   W   W  W  W
W   W   W    W   WWWWW   W   W   W  W  W
W   W   W    Wm          W   W   W  W  W
W   W   W    WWWWWWWWWWWWW   W   W  W  W
W   W   Wm                  mW   W  W  W
WWWWWWWWWWWWWWWWWWWWWWWWWWWWWWWWWWWWWWWW