WWWWWWWWWWWWWWWWWWWWWWWWWWWWWWWWWWWWWWWWWWW
W A                                       W
W                                         W
W                                         W
W                             g           W
W                                         W
W                                         W
W                                         W
W                                         W
W                                         W
W       c          a                      W
W                                         W
W                                         W
W                                         W
W                                         W
W                                         W
W                                         W
W                                         W
W                                         W
W                                       g W
W                                         W
W                                       c W
W                                       a W
W                               g  c  a   W
WWWWWWWWWWWWWWWWWWWWWWWWWWWWWWWWWWWWWWWWWWW