WWWWWWWWWWWWWWWWWWWWWWWWWWWWWWWWWW
W   g                            W
W  c                             W
W   a                            W
W        WWWWWWWWWWWWWWWW        W
W        W a                     W
W        W                  W    W
W        W                  W    W
W        W        A         W    W
W        W                  W    W
W        W                  W    W
W        W c              g W    W
W        WWWWWWWWWWWWWWWWWWWW    W
WWWWWWWWWWWWWWWWWWWWWWWWWWWWWWWWWW