WWWWWWWWWWWWWWWWWWWWWW
a WWWW
WWWWW  WWW  WWWWWWWWWW
WWWWWW  WW  WWWWWWWWWW
WWWWWWWW    WWWWWWWWWW
Wg       A  A      c W
WWWWWWWWWW    WWWWWWWW
WWWWWWWWWW  WW gWWWWWW
WWWWWWWWWW  WWWW  WWWW
WWWWWWWWWW cWWWWWW  WW
WWWWWWWWWWWWWWWWWWWWWW
Wg       cW
A
a
WWWWWWWWWWW