#############################################
#  a                  c                 a   #
#    A                                 A    #
#  g                  c                 g   #
#############################################
#                     c                     #
#                                           #
# g  A                                 A  a #
#                                           #
#                     c                     #
#############################################
#  c                  a                 c   #
#    A                                 A    #
#  g                  a                 g   #
#############################################