########################################################################################
###########   a    ##########################         ##########################    a ##
######                 ######################     g                   a######        ###
#######   c     #    g     ###############              #################    c     #####
#########         ###        ###########                 ################       ########
############        ###         ########       c         ###########   g     ###########
################      ##           #####                  ########         #############
#########                          ###    c        a     ######        #################
##########      #######              #       AAAAAA        ###       ######      #######
#######   a     #########       g            AAAAAA                    ########        #
######            ##########                 AAAAAA                      #########    ##
###        #          ########               AAAAAA          #####      #######        #
##   c   #####            ######             AAAAAA       #########       ####     c   #
#        ####        a       #####            g          ##########                    #
## g     ###   c              ###                         ###########    g    g        #
###     c  ###        g    ###                               ########                  #
######      ####         ####       a        g               #########      ###     c  #
#######         #########      g                              #########    ######      #
##########           c               ###              g      ##########      ####      #
##########     g                    #####                   ###########   a   ####     #
################      ##    c      #######                 #############      ####     #
##                  ###         ###########        c      ############  c        #     #
###  g             ###   g    ###############            #############    a        g   #
##          a   ####       ####################       #########################        #
######  c   ###             #################                                          #
###########            c                         a    ###########################      #
##########         ##########################         ##########################       #
###########       ###########################        ##########################        #
###########   a                                       #################             a ##
######                 ######################     g                   a###           ###
#######   c     #    g     ###############              #################    c     #####
#########                    ###########                 ################       ########
############                    ########       c         ###########   g     ###########
################      ##           #####                  ########         #############
#########                          ###    c        a     ######        #################
##########      #######              #       AAAAAA        ###       ######      #######
#######   a     #########       g            AAAAAA                    ###   a         #
######            ##########                 AAAAAA                      ###          ##
###        #          ########               AAAAAA          #####      #######        #
##   c   #####            ######             AAAAAA       #########       ####     c   #
#        ####        a       #####            g          ##########                    #
## g     ###   c              ###                         ###########    g    g        #
###     c  ###        g    ###                               ########                  #
######      ####         ####       a        g               #########      ###     c  #
#######         #########      g                              #########    ######      #
##########           c               ###              g      ##########      ####      #
##########     g                    #####                   ###########   a   ####     #
################      ##    c      #######                 #############      ####     #
##                  ###         ###########        c      ############  c        #     #
###  g             ###   g      #############            #############    a        g   #
##          a   ####             ##############       #########################        #
######  c   ###                    #########                                           #
###########        #   c                         a    ##################################
#####################                         ##########################################
#####################  a   c                               g   c   #####################
#######     c                                g     c    A   c   ########################
######   g       ######                         c     g       ##########################
#####         c   #################                 #################       c   g  #####
####   a   g       ###############   c       g       #############   a       g       c #
###           c       #############                   ###########                   g  #
##   c   #######   g   ###########   c                 #########   g                 c #
##   g   ###########   ###########                                                     #
#   a   #############   #######   g                    ######       #######   g        #
#     #################   ######                                                       #
#    ###################   #####          #######       ######       ###        ########
#   #####################   ####                                      ##################
#  #######################   ###  ############                 c       #################
# #########################   ## ################                   g   ################
# ##########################                                      g   c   ##############
# ##########################   #######                                 a   #############
# #####################                                                   ##############
# ######################                                            g   c   ############
# ##################   g           g                                        ############
# ################                                                  c   g   ############
# ###############                                                   a       ############
# ###########   g        c              g                                   ############
# #######       c  a                                            c   g       ############
# ##   a                                            a               c       ############
#               a                                                       c   ############
#   g                  #                                                g   ############
#   c                ######################   g    c                          ##########
#                   ####################                                    g   ########
#   g              ####################                    c                    ########
##                ###################                 ###############   g   c   ########
###              ###################               ##################       a   ########
#######   a      ##################                 ################       g   #########
########         #################                    a   g                    #########
##########       ################                                 c         c   ########
###########   g   ###############     AAAAAAAAAAA     ##############   g       #########
############      ##############                        ###########       c   ##########
#############       ###########                          ########   g       ############
##############   a    ########                 #####      #######           ############
###############                                             #####           ############
################   g                                     c   ###   g   c   #############
#################                                      g       a       #################
#c                                                                    ##################
#     ################                                     g   a       #################
#                    a##                              a        g        ################
########################################################################################

