WWWWWWWWWWWWWWWWWWWWWWWWWWWWWWWWWWWWWWWWWWWWW
W A                                         W
WWWWWWWWWWWWWWWWWWWWWWWWW                   W
W c                   g                     W
W                                           W
W                                           W
W              a   WWWWWWWWWWWWWWWWWWWWWWWWWW
W                                           W
W                      g                    W
W                                           W
WWWWWWWWWWWWWWWWWWWWWWWWWWW                 W
W  a                     c                  W
W  g                                        W
W                                           W
WWWWWWWWWWWWWWWWWWWWWWWWWWWWWWWWWWWWWWWWWWWWW
W  c                  a                 c   W
W    A                                 A    W
W  g                  a                 g   W
WWWWWWWWWWWWWWWWWWWWWWWWWWWWWWWWWWWWWWWWWWWWW