#############################################
# A                                         #
#########################                   #
# c                   g                     #
#                                           #
#                                           #
#              a   ##########################
#                                           #
#                      g                    #
#                                           #
###########################                 #
#  a                     c                  #
#  g                                        #
#                                           #
#############################################
#  c                  a                 c   #
#    A                                 A    #
#  g                  a                 g   #
#############################################