WWWWWWWWWWWW          
W          W          
W          W          
W   a    A W          
W          W          
W          W          
W          W          
W          W          
W   g   m  W          
W          W          
W          W          
W          W          
WWWWWWWWWWWW          
WWWWWWWWWWWW          
WWWWWWWWWWWW          
WWWWWWWWWWWW          
W          W          
W          W          
W   m    g W          
W          W          
W          W          
W          W          
W          W          
W   A   a  W          
W          W          
W          W          
W          W          
WWWWWWWWWWWW          
WWWWWWWWWWWW          
WWWWWWWWWWWW          
WWWWWWWWWWWW          
W          W          
W          W          
W   a    g W          
W          W          
W          W          
W          W          
W          W          
W   m   A  W          
W          W          
W          W          
W          W          
WWWWWWWWWWWW          
WWWWWWWWWWWW          
WWWWWWWWWWWW            
WWWWWWWWWWWW          
W          W          
W          W          
W   a    A W          
W          W          
W          W          
W   g      W          
W          W          
W       m  W          
W          W          
W          W          
W          W          
WWWWWWWWWWWW  