WWWWWWWWWWWWWWWWWWWWWWW
W                     W
W                     W
W                     W
W                     W
W                     W
W                     W
W                     W
W                     W
W                     W
W                     W
W    g     mA    g    W
W                     W
W                     W
W                     W
W                     W
W                     W
W                     W
W                     W
W                     W
W                     W
WWWWWWWWWWWWWWWWWWWWWWW
WWWWWWWWWWWWWWWWWWWWWWW
W                     W
W                     W
W                     W
W                     W
W                     W
W                     W
W                     W
W                     W
W                     W
W                     W
W    g     mA    g    W
W                     W
W                     W
W                     W
W                     W
W                     W
W                     W
W                     W
W                     W
W                     W
WWWWWWWWWWWWWWWWWWWWWWW