WWWWWWWWWWWWWWWWWWWWWWWWWWWWWWWWW WWWWWWWWWWWWWWWWWWWWWWWWWWWWWWWWWW WWWWWWWWWWWWWWWWWWWWWWWWWWWWWWWWWW WWWWWWWWWWWWWWWWWWWWWWWWWWWWWWWWWW
W                W              W W                W              W W                W              W W                W              W
W   A            W              W W   A            W              W W   A            W              W W   A            W              W
W                W              W W                W              W W                W              W W                W              W
W                W              W W                W              W W                W              W W                W              W
W       W        W              W W                W              W W       W        W              W W                W              W
W       W        W              W W                W              W W       W        W              W W                W             W
W       W        W  g           W W       W        W  g           W W       W        W  g           W W                W  g           W
W   a   W        W              W W   a   W        W              W W   a   W        W              W W   a            W              W
WWWWWWWWW        WWWWWWW        W WWWWWWWW        WWWWWWW        W WWWWWWWW        WWWWWWW        W WWWWWWWWWW       WWWWWWWW         W
W                               W W                               W W                               W W                               W
W                               W W                               W W                               W W                               W
W                               W W                               W W                               W W                               W
W                      WWWWWWWWWW W                      WWWWWWWWWW W                      WWWWWWWWWW W                      WWWWWWWWWW
W                               W W                               W W                               W W                               W
W                          m    W W                          m    W W                          m    W W                          m    W
W                               W W                               W W                               W W                               W
W                               W W                               W W                               W W                               W
WWWWWWWWWWWWWWWWWWWWWWWWWWWWWWWWW WWWWWWWWWWWWWWWWWWWWWWWWWWWWWWWWWW WWWWWWWWWWWWWWWWWWWWWWWWWWWWWWWWWW WWWWWWWWWWWWWWWWWWWWWWWWWWWWWWW
WWWWWWWWWWWWWWWWWWWWWWWWWWWWWWWWWWWWWWWWWWWWWWWWWWWWWWWWWWWWWWWWWWWWWWWWWWW
W      W      WW      W      WW      W      WW      W      WW      W      W
W      W  A   WW      W  A   WW      W  A   WW      W  A   WW      W  A   W
W             WW             WW             WW             WW             W
W             WW             WW             WW             WW             W
W         WWWWWW         WWWWWW         WWWWWW         WWWWWW         WWWWW
Wm  W         WWm  W         WWm  W         WWm            WWm  W         W
WWWWWW        WWWWWWW        WWWWWWW        WWWWWWW        WWWWWWW        W
W             WW             WW             WW             WW             W
W             WW             WW             WW             WW             W
W             WW             WW             WW             WW             W
W      W      WW      W      WW      W      WW      W      WW      W      W
W  g   W   a  WW  g   W   a  WW  g   W   a  WW  g   W   a  WW  g   W   a  W
W      W      WW      W      WW      W      WW      W      WW      W      W
WWWWWWWWWWWWWWWWWWWWWWWWWWWWWWWWWWWWWWWWWWWWWWWWWWWWWWWWWWWWWWWWWWWWWWWWWWW