WWWWWWWWWWWWWWWWWWWWWWWWWWWWWWWWWWWWWWWWWWWWWWWWWWWWWWWWWWWWWWWWWWWWWWWWWWWWWWWWWWWWWWWWWWWWWWWWWWWWWWWWWWWWWWWWWWWWWWWWWWWWWWWWWWWWWWW
W                W              W W                W              W W                W              W W                W              W
W   A            W              W W   A            W              W W   A            W              W W   A            W              W
W                W              W W                W              W W                W              W W                W              W
W                W              W W                W              W W                W              W W                W              W
W       W        W              W W                W              W W       W        W              W W                W              W
W       W        W              W W                W              W W       W        W              W W                W              W
W       W        W  g           W W       W        W  g           W W       W        W  g           W W                W  g           W
W   a   W        W              W W   a   W        W              W W   a   W        W              W W   a            W              W
WWWWWWWWW        WWWWWWW        W WWWWWWWW        WWWWWWW        W WWWWWWWWWW      WWWWWWW        W WWWWWWWWWW       WWWWWWWW         W
W                               W W                               W W                               W W                               W
W                               W W                               W W                               W W                               W
W                               W W                               W W                               W W                               W
W                      WWWWWWWWWW W                      WWWWWWWWWW W                      WWWWWWWWWW W                      WWWWWWWWWW
W                               W W                               W W                               W W                               W
W                          m    W W                          m    W W                          m    W W                          m    W
W                               W W                               W W                               W W                               W
W                               W W                               W W                               W W                               W
WWWWWWWWWWWWWWWWWWWWWWWWWWWWWWWWWWWWWWWWWWWWWWWWWWWWWWWWWWWWWWWWWWWWWWWWWWWWWWWWWWWWWWWWWWWWWWWWWWWWWWWWWWWWWWWWWWWWWWWWWWWWWWWWWWWWWWW
WWWWWWWWWWWWWWWWWWWWWWWWWWWWWWWWWWWWWWWWWWWWWWWWWWWWWWWWWWWWWWWWWWWWWWWWWWWWWWWWWWWWWWWWWWWWWWWWWWWWWWWWWWWWWWWWWWWWWWWWWWWWWWWWWWWWWWW
W                W              W W                W              W W                W              W W                W              W
W   A            W              W W   A            W              W W   A            W              W W   A            W              W
W                W              W W                W              W W                W              W W                W              W
W                W              W W                W              W W                W              W W                W              W
W       W        W              W W                W              W W       W        W              W W                W              W
W       W        W              W W                W              W W       W        W              W W                W              W
W       W        W  g           W W       W        W  g           W W       W        W  g           W W                W  g           W
W   a   W        W              W W   a   W        W              W W   a   W        W              W W   a            W              W
WWWWWWWWW        WWWWWWW        W WWWWWWWW        WWWWWWW        W WWWWWWWWWW      WWWWWWW        W WWWWWWWWWW       WWWWWWWW         W
W                               W W                               W W                               W W                               W
W                               W W                               W W                               W W                               W
W                               W W                               W W                               W W                               W
W                      WWWWWWWWWW W                      WWWWWWWWWW W                      WWWWWWWWWW W                      WWWWWWWWWW
W                               W W                               W W                               W W                               W
W                          m    W W                          m    W W                          m    W W                          m    W
W                               W W                               W W                               W W                               W
W                               W W                               W W                               W W                               W
WWWWWWWWWWWWWWWWWWWWWWWWWWWWWWWWWWWWWWWWWWWWWWWWWWWWWWWWWWWWWWWWWWWWWWWWWWWWWWWWWWWWWWWWWWWWWWWWWWWWWWWWWWWWWWWWWWWWWWWWWWWWWWWWWWWWWWW
WWWWWWWWWWWWWWWWWWWWWWWWWWWWWWWWWWWWWWWWWWWWWWWWWWWWWWWWWWWWWWWWWWWWWWWWWWWWWWWWWWWWWWWWWWWWWWWWWWWWWWWWWWWWWWWWWWWWWWWWWWWWWWW
W      W      W W             W W             W W             W W      W      W W             W W             W W             W
W  A   W  g   W W  A          W W          A  W W   g      A  W W  A   W      W W  A          W W          A  W W         A   W
W             W W             W W             W W             W W      W      W W             W W             W W             W
W             W W         g   W W   g         W W             W W      W  g   W W         g   W W   g         W W             W
W             W W      W      W W      W      W W      W      W W             W W      W      W W      W      W W      W      W
W  m          W W  m   W      W W      W   m  W W      W   m  W W  m          W W  m   W      W W      W   m  W W      W   m  W
WWWW          W WWWWWWWW      W W      WWWWWWWW W      WWWWWWWW W WWWWWW      WWWWWWWWWW    W W         WWWWWWW     WWWWWWWWWWW
W            W W              W W             W W      W      W W             W W              W W             W W      W     W
W             W W             W W             W W      W      W W             W W             W W             W W      W      W
W             W W             W W             W W         a   W W             W W             W W             W W      W  a   W
W  a          W W  a   W      W W      W  a   W W             W W  a          W W  a   W      W W       W  a  W W             W
W      W      W W      W      W W      W      W W             W W      W      W W      W      W W       W     W W    g        W
W      WWWWWWWW W      WWWWWWWW WWWWWWWW      W WWWWW         W W      WWWWWWWW W      WWWWWWWW W       W WWWWW               W
WWWWWWWWWWWWWWWWWWWWWWWWWWWWWWWWWWWWWWWWWWWWWWWWWWWWWWWWWWWWWWWWWWWWWWWWWWWWWWWWWWWWWWWWWWWWWWWWWWWWWWWWWWWWWWWWWWWWWWWWWWWWWWW