WWWWWWWWWWWWWWWWWWWWWWWWWWWWWWWWWWWWWWWWWWWWWWWWWWWWWWWWWWWWWWWWWWWWWWWWWWWWWWWWWWWWWWWWWW
W                                                                                        W
W                                                                                        W
W         WWWWWWWWWWWWWWWWWWWWWWWWW                                                      W
W         W                        W                                                     W
W         W           g            W                                                     W
W         W                        W                                                     W
W         WWWWWWWWWW       WWWWWWWWW                                                     W
W                                                                                        W
W     WWWWWWW                              WWWWWWWWWWWWWWWWWW                            W
W     W  m  W                      W                        W                            W
W                                  W           m            W                            W
W                                  W                        W                            W
W                                  WWWWWWWWWWWWWWWWWWWWWWWWW                             W
W                                                                                        W
W                                                                                        W
W                   WWWWWWWWWWW          WWWWWWWWWWWWW                                  W
W                   W                                W                                   W
W                   W               a                W                                   W
W                   W                                W                                   W
W                   WWWWWWWWWWWWWWWWWWWWWWWWWWWWWWWWWW                          W
W                                                                                        W
W                                                                                        W
W         WWWWWWWWWWWWWWWWWWWW                                                           W
W         W                W                                                             W
W         W       c        W                                                             W
W         W                W                                                             W
W         WWWWWWWWWWWWWWWWWWWW                                                           W
W                                                                                        W
W                                                                                        W
W                                                                                        W
W                                                                                        W
W                                    WWWWWWWWWWWWW                                       W
W                                    W          W                                        W
W                                    W    m     W                                        W
W                                    W          W                                        W
W                                    WWWWWWWWWWWWW                                       W
W                                                                                        W
W                                                                                        W
W                                                                                        W
W                                                                                        W
W                                                                                        W
W          WWWWWWWWWWWWWWWWWWWWWWWWWWWWWW                                                W
W          W                          W                                                  W
W          W             g            W                                                  W
W          W                          W                                                  W
W          WWWWWWWWWWWWWWWWWWWWWWWWWWWWWW                                                W
W                                                                                        W
W                                                                                        W
W                                                                                        W
W                                                                                        W
W           VVVVVVV                                                                      W
W           V     V                                                                      W
W           V  m  V                                                                      W
W           V     V                                                                      W
W           VVVVVVV                                                                      W
W                                                                                        W
W                                                                                        W
W                                                                                        W
W                                                                                        W
W                        WWWWWWWWWWWWWWWWWWWWWWWWWWWWWW                                  W
W                        W                            W                                  W
W                        W             a              W                                  W
W                        W                            W                                  W
W                        WWWWWWWWWWWWWWWWWWWWWWWWWWWWWW                                  W
W                                                                                        W
W                                                                                        W
W                                                                                        W
W                                                                                        W
W        WWWWWWWWWWWWWWWWWWWWWWWWW                                                       W
W        W                        W                                                      W
W        W            c           W                                                      W
W        W                        W                                                      W
W        WWWWWWWWWWWWWWWWWWWWWWWWW                                                       W
W                                                                                        W
W                                                                                        W
W                                                                                        W
W                                                                                        W
W                        VVVVVVV                                                         W
W                        V     V                                                         W
W                        V  g  V                                                         W
W                        V     V                                                         W
W                        VVVVVVV                                                         W
W                                                                                        W
W                                                                                        W
W                                                                                        W
W                                                                                        W
W                                      WWWWWWWWWWWWWWWWWWWWWWWWWWWWWW                    W
W                                      W                            W                    W
W                                      W             m              W                    W
W                                      W                            W                    W
W                                      WWWWWWWWWWWWWWWWWWWWWWWWWWWWWW                    W
W                                                                                        W
W                                                                                        W
W                                                                                        W
W                                                                                        W
W             WWWWWWWWWWWWWWWWWWWWWWWWWWWWWWWWWW                                         W
W             W                                W                                         W
W             W               a                W                                         W
W             W                                W                                         W
W             WWWWWWWWWWWWWWWWWWWWWWWWWWWWWWWWWW                                         W
W                                                                                        W
W                                                                                        W
W      VVVVVVV                                                                           W
W      V     V                                                                           W
W      V  m  V                                                                           W
W      V     V                                                                           W
W      VVVVVVV                                                                           W
W                                                                                        W
W                                                                                        W
W                                                                                        W
W                                                                                        W
WWWWWWWWWWWWWWWWWWWWWWWWWWWWWWWWWWWWWWWWWWWWWWWWWWWWWWWWWWWWWWWWWWWWWWWWWWWWWWWWWWWWWWWWWW