WWWWWWWWWWWWWWW
W      W      W
W      W  A   W
W             W
W             W
W         WWWWW
Wm  W         W
WWWWWW        W
W             W
W             W
W             W
W      W      W
W  g   W   a  W
W      W      W
WWWWWWWWWWWWWWW