WWWWWWWWWWWWWWWWWWWWWWWWWWWWWWWWWWWWWWWWWWWWWWWWWWWWWWWWWWWWWWWWWWWWWWWWWWWWWWWWWWWWWWWWW
W A    bbb      bbb      bbb      bbb      bbb      bbb      bbb      bbb      bbb      W
W      bbb      bbb      bbb      bbb      bbb      bbb      bbb      bbb      bbb      W
W  m   bbb  m   bbb  m   bbb  m   bbb  m   bbb  m   bbb  m   bbb  m   bbb  m   bbb  m   W
W      bbb      bbb      bbb      bbb      bbb      bbb      bbb      bbb      bbb      W
W      bbb      bbb      bbb      bbb      bbb      bbb      bbb      bbb      bbb      W
WbbbbbbbbbbbbbbbbbbbbbbbbbbbbbbbbbbbbbbbbbbbbbbbbbbbbbbbbbbbbbbbbbbbbbbbbbbbbbbbbbbbbbbbW
WbbbbbbbbbbbbbbbbbbbbbbbbbbbbbbbbbbbbbbbbbbbbbbbbbbbbbbbbbbbbbbbbbbbbbbbbbbbbbbbbbbbbbbbW
WbbbbbbbbbbbbbbbbbbbbbbbbbbbbbbbbbbbbbbbbbbbbbbbbbbbbbbbbbbbbbbbbbbbbbbbbbbbbbbbbbbbbbbbW
W      bbb      bbb      bbb      bbb      bbb      bbb      bbb      bbb      bbb      W
W      bbb      bbb      bbb      bbb      bbb      bbb      bbb      bbb      bbb      W
W  m   bbb  m   bbb  m   bbb  m   bbb  m   bbb  m   bbb  m   bbb  m   bbb  m   bbb  m   W
W      bbb      bbb      bbb      bbb      bbb      bbb      bbb      bbb      bbb      W
W      bbb      bbb      bbb      bbb      bbb      bbb      bbb      bbb      bbb      W
WbbbbbbbbbbbbbbbbbbbbbbbbbbbbbbbbbbbbbbbbbbbbbbbbbbbbbbbbbbbbbbbbbbbbbbbbbbbbbbbbbbbbbbbW
WbbbbbbbbbbbbbbbbbbbbbbbbbbbbbbbbbbbbbbbbbbbbbbbbbbbbbbbbbbbbbbbbbbbbbbbbbbbbbbbbbbbbbbbW
WbbbbbbbbbbbbbbbbbbbbbbbbbbbbbbbbbbbbbbbbbbbbbbbbbbbbbbbbbbbbbbbbbbbbbbbbbbbbbbbbbbbbbbbW
W      bbb      bbb      bbb      bbb      bbb      bbb      bbb      bbb      bbb      W
W      bbb      bbb      bbb      bbb      bbb      bbb      bbb      bbb      bbb      W
W  m   bbb  m   bbb  m   bbb  m   bbb  m   bbb  m   bbb  m   bbb  m   bbb  m   bbb  m   W
W      bbb      bbb      bbb      bbb      bbb      bbb      bbb      bbb      bbb      W
W      bbb      bbb      bbb      bbb      bbb      bbb      bbb      bbb      bbb      W
WWWWWWWWWWWWWWWWWWWWWWWWWWWWWWWWWWWWWWWWWWWWWWWWWWWWWWWWWWWWWWWWWWWWWWWWWWWWWWWWWWWWWWWWW