####################
#   A      #       #
#  #               #
#       m  #       #
##    # ## ##     ##
#    #             #
#               a  #
#       ##         #
#                  #
#                  #
#   ##       ##    #
#   ##  m   ##     #
#        ##        #
#  ####       #### #
#   g      ##   a  #
#   ####  ####     #
#                  #
#       a          #
#                  #
####################