WWWWWWWWWWWWWWWWWWWWWWWWWWWWWWWWWWWWWWWW
W                                      W
W                                      W
W                                      W
W              g              m        W
W                                      W
W                                      W
W                        m             W
W                                      W
W                   a                  W
W                                      W
W                                  g   W
W                                      W
W                                      W
W         A                   m        W
W                                      W
W                                      W
W         a                            W
W                                      W
W                        g             W
W                                      W
W                             m        W
W                                      W
W                                      W
W              m                       W
W                                      W
W                                      W
W                   g                  W
W                                      W
W                                  a   W
W                                      W
W                                      W
W              a                       W
W                                      W
W                   g                  W
W                                      W
W                                      W
W                                      W
W                                      W
WWWWWWWWWWWWWWWWWWWWWWWWWWWWWWWWWWWWWWWW