WWWWWWWWWWWWWWWWWWWWWWWWW
W   m       g      a    W
W       a       m       W
W    g         c        W
W           m           W
W  a                g   W
W         m           c W
W                       W
W      g         m      W
W          a           W
W                       W
W   c   m       g       W
W            A          W
W    g            a     W
W m                    cW
W                       W
W                   a   W
W  g           m        W
W                       W
W         c          a  W
W      m    g    a      W
W                       W
W                      mW
W                       W
WWWWWWWWWWWWWWWWWWWWWWWWW