WWWWWWWWWWWWWWWWWWWWWWWWWWWWWWWWWWWWWWWWWWWWWWWWWWWWWWWWWWWWWWWWWWWWWWWWWWWWWWWWWWWWWWWWWWWWWWWWWWWWWWWWWWWWWWWWWWWWWWWWWWWWWWWWWWWWWWW
W                W              W W                W              W W                W              W W                W              W
W   A            W              W W   A            W              W W   A            W              W W   A            W              W
W                W              W W                W              W W                W              W W                W              W
W                W              W W                W              W W                W              W W                W              W
W                W              W W                W              W W       W        W              W W                W              W
W                W              W W                W              W W       W        W              W W                W              W
W                W  g           W W       W        W  g           W W       W        W  g           W W                W  g           W
W   a            W              W W   a   W        W              W W   a   W        W              W W   a            W              W
WWWWWWWWW        WWW            W WWWWWWWW        WWWWWWW        W WWWWWWWWWW      WWWWWWW        W WWWWWWWWWW       WWWWWWWW         W
W                               W W                               W W                               W W                               W
W                               W W                               W W                               W W                               W
W                               W W                               W W                               W W                               W
W                      WWWWWWWWWW W                      WWWWWWWWWW W                      WWWWWWWWWW W                      WWWWWWWWWW
W                               W W                               W W                               W W                               W
W                          m    W W                          m    W W                          m    W W                          m    W
W                               W W                               W W                               W W                               W
W                               W W                               W W                               W W                               W
WWWWWWWWWWWWWWWWWWWWWWWWWWWWWWWWW WWWWWWWWWWWWWWWWWWWWWWWWWWWWWWWWWWWWWWWWWWWWWWWWWWWWWWWWWWWWWWWWWWWWWWWWWWWWWWWWWWWWWWWWWWWWWWWWWWWWW
WWWWWWWWWWWWWWWWWWWWWWWWWWWWWWWWWWWWWWWWWWWWWWWWWWWWWWWWWWWWWWWWWWWWWWWWWWWWWWWWWWWWWWWWWWWWWWWWWWWWWWWWWWWWWWWWWWWWWWWWWWWWWWWWWWWWWWW WWWWWWWWWWWWWWWWWWWWWWWWWWWWWWWWWWWWWWWWWWWWWWWWWWWWWWWWWWWWWWWWWWWWWWWWWWWWWWWWWWWWWWWWWWWWWWWWWWWWWWWWWWWWWWWWWWWWWWWWWWWWWWWWWWWWWWWW WWWWWWWWWWWWWWWWWWWWWWWWWWWWWWWWWWWWWWWWWWWWWWWWWWWWWWWWWWWWWWWWWWWWWWWWWWWWWWWWWWWWWWWWWWWWWWWWWWWWWWWWWWWWWWWWWWWWWWWWWWWWWWWWWWWWWWWW WWWWWWWWWWWWWWWWWWWWWWWWWWWWWWWWWWWWWWWWWWWWWWWWWWWWWWWWWWWWWWWWWWWWWWWWWWWWWWWWWWWWWWWWWWWWWWWWWWWWWWWWWWWWWWWWWWWWWWWWWWWWWWWWWWWWWWWW
W                W              W W                W              W W                W              W W                W              W W                W              W W                W              W
W                W              W W                W              W W                W              W W                W              W W                W              W W                W              W
W   A            W              W W   A            W              W W   A            W              W W   A            W              W W   A            W              W
W                W              W W   A            W              W W                W              W W   A            W              W W   A            W              W
W                W              W W                W              W W                W              W W                W              W W                W              W
W                W              W W                W              W W                W              W W                W              W W                W              W
W                W  g           W W       W        W  g           W W       W        W  g           W W                W  g           W W       W        W  g           W
W                W  g           W W       W        W  g           W W       W        W  g           W W                W  g           W W       W        W  g           W
W   a            W              W W   a   W        W              W W   a   W        W              W W   a            W              W W   a            W              W
W   a            W              W W   a   W        W              W W   a   W        W              W W   a            W              W W   a            W              W
WWWWWWWWW        WWW            W WWWWWWWW        WWWWWWW        W WWWWWWWWWW      WWWWWWW        W WWWWWWWWWW       WWWWWWWW         W WWWWWWWWWW        WWW            W WWWWWWW        W WWWWWWWWWW       WWWWWWWW         W
WWWWWWWWW        WWW            W WWWWWWWW        WWWWWWW        W WWWWWWWWWW      WWWWWWW        W WWWWWWWWWW       WWWWWWWW         W 
W                               W W                               W W                               W W                               W W                               W
W                               W W                               W W                               W W                               W W                               W
W                               W W                               W W                               W W                               W W                               W
W                      WWWWWWWWWW W                      WWWWWWWWWW W                      WWWWWWWWWW W                      WWWWWWWWWW
W                      WWWWWWWWWW W                      WWWWWWWWWW W                      WWWWWWWWWW W                      WWWWWWWWWW
W                               W W                               W W                               W W                               W W                               W
W                               W W                               W W                               W W                               W W                               W
W                          m    W W                          m    W W                          m    W W                          m    W W                          m    W
W                          m    W W                          m    W W                          m    W W                          m    W W                          m    W
W                               W W                               W W                               W W                               W W                               W
W                               W W                               W W                               W W                               W W                               W
WWWWWWWWWWWWWWWWWWWWWWWWWWWWWWWWW WWWWWWWWWWWWWWWWWWWWWWWWWWWWWWWWWWWWWWWWWWWWWWWWWWWWWWWWWWWWWWWWWWWWWWWWWWWWWWWWWWWWWWWWWWWWWWWWWWWWWWWWWW WWWWWWWWWWWWWWWWWWWWWWWWWWWWWW