WWWWWWWWWWWWWWWWWWWWWWWWWWWWWWWWWWWWWWWWWWWWWWWWWWWWWWWWWWWWWWWWWWWWWWWWWWWWWWWWWW
W                                      W W                                     W
W  A    m                              W W      m                               W
W              b              b        W W              b              b        W
W             bgb            bmb       W W             bgb            bmb       W
W              b              b        W W              b              b        W
W      b                  b            W W      b                  b            W
W     bmb               bmb            W W     bmb               bmb            W
W      b            b    b             W W      b            b    b             W
W                  bab                 W W                  bab                 W
W                   b              b   W W                   b              b   W
W                                 bgb  W W                                 bgb  W
W                                  b   W W                                  b   W
W                             b        W W                             b        W
W                            bmb       W W         A                  bmb       W
W                             b        W W                             b        W
W         b                            W W         b                            W
W        bab                           W W        bab                           W
W         b              b             W W         b              b             W
W                       bgb            W W                       bgb            W
W                        b    b        W W                        b    b        W
W                            bmb       W W                            bmb       W
W                             b        W W                             b        W
W              b                       W W              b                       W
W             bmb                      W W             bmb                      W
W              b                       W W              b                       W
W                   b                  W W                   b                  W
W                  bgb                 W W                  bgb                 W
W                   b              b   W W                   b              b   W
W                                 bab  W W                                 bab  W
W                                  b   W W                                  b   W
W              b                                        b                       W
W             bab                                      bab                      W
W              b    b                                   b    b                  W
W                  bgb                                      bgb                 W
W                   b                                        b                  W
W                                                                               W
W                                                                               W
W                                                                               W
W                                                                               W
W                                        WWWWWWWWWWWWWWWWWWWWWWWWWWWWWWWWWWWWWWWW
W                                      W W                                      W
W  A    m                              W W      m                               W
W              b              b        W W              b              b        W
W             bgb            bmb       W W             bgb            bmb       W
W              b              b        W W              b              b        W
W      b                  b            W W      b                  b            W
W     bmb               bmb            W W     bmb               bmb            W
W      b            b    b             W W      b            b    b             W
W                  bab                 W W                  bab                 W
W                   b              b   W W                   b              b   W
W                                 bgb  W W                                 bgb  W
W                                  b   W W                                  b   W
W                             b        W W                             b        W
W                            bmb       W W         A                  bmb       W
W                             b        W W                             b        W
W         b                            W W         b                            W
W        bab                           W W        bab                           W
W         b              b             W W         b              b             W
W                       bgb            W W                       bgb            W
W                        b    b        W W                        b    b        W
W                            bmb       W W                            bmb       W
W                             b        W W                             b        W
W              b                       W W              b                       W
W             bmb                      W W             bmb                      W
W              b                       W W              b                       W
W                   b                  W W                   b                  W
W                  bgb                 W W                  bgb                 W
W                   b              b   W W                   b              b   W
W                                 bab  W W                                 bab  W
W                                  b   W W                                  b   W
W              b                                        b                       W
W             bab                                      bab                      W
W              b    b                                   b    b                  W
W                  bgb                                      bgb                 W
W                   b                                        b                  W
W                                                                               W
W                                                                               W
W                                                                               W
WWWWWWWWWWWWWWWWWWWWWWWWWWWWWWWWWWWWWWWWWWWWWWWWWWWWWWWWWWWWWWWWWWWWWWWWWWWWWWWWW