WWWWWWWWWWWWWWWWWWWWWWWWWWWWWWWWWWWWWWWW
W                                      W
W                                      W
W             WWW              WWWWW   W
W              g              m        W
W             WWW              WWWWW   W
W                                      W
W                                      W
W                  W W                 W
W                  WaW                 W
W                  W W                 W
W                                      W
W                                      W
W                                      W
W         A                            W
W                                      W
W      WWWWWWW                         W
W         a                            W
W      WWWWWWW                         W
W                            W W       W
W                            W W       W
W                            WmW       W
W                            W W       W
W             W W            W W       W
W             WmW                      W
W             W W                      W
W                                      W
W                                      W
W                                      W
W                WWWWWWWW              W
W                   g                  W
W                WWWWWWWW              W
W                                      W
W                                      W
W                                      W
W                                      W
W                                      W
W                                      W
W                                      W
WWWWWWWWWWWWWWWWWWWWWWWWWWWWWWWWWWWWWWWW