WWWWWWWWWWWWWWWWWWWWWWWWWWWWWWWWWWWWWWWWWWWWWWWWWW
W WWWWW                                          W
W     W     W     W     WW   WWWWW     W     W   W
W WWWW                                     WWWWW W
W     W     W     W     W     W     W     W      W
W WWWW W        WWW W    W WW            WWWWW   W
W     W     W     W     W     W     W     W      W
W WWWWW WWWWW       WWWWW WW        W    WW    WWW
W     W     W     W     W     W     W     W      W
W WWWWWW W      WWWWWW WWWWWW WWWWWW WWWWWW WWWWWW
W     W            W     W     W     W           W
W   W     W   W     W   W     W   W     W   W    W
W W WWW      WWW W W                W    W W  W  W
W W           W W W     W W   W W W   W W     W WW
W WWWWW    W WWW WWW W            WW WW WW WWWWW W
W     W     W     W   W           W     W     W  W
W WWW WWW      WWWWWW     W     WWW WWW WW WW WWWW
W   W   W     W         W         W   W   W     WW
W WWW WWWWWW    WWW WWWWWW       WWWW         WWWW
W   W     W     W   W     W           W   W      W 
W                                                W
W     W     W     W   W     W     W     W     W  W
W WWWWW          WW WWWWW WW              W     WW 
W     W     W     W     W     W     W     W      W
W WWWWWW WWWWWW WWWWWW                      W    W 
W     W     W     W     W     W     W     W      W
W WWWW W        WWW W         WWW        WWWWWW  W
W     W     W     W     W     W     W     W      W
W WWWWW             W      W                 WW  W 
W     W     W     W           W     W     W      W
W WWWWWW W      WWWW   WWW   WW   W        WW    W
W     W            W     W     W     W           W
W   W     W   W     W   W     W   W     W   W    W
W W WWW                                          W
W W           W W W     W W   W W W   W W     W  W
W                                                W
W     W     W     W   W           W     W        W
W WWW WWW      WWWWWW     W  WW WWW WWW         WW
W   W   W     W         W   W     W   W   W     WW
W WWW WWWWWW    WWW W                            W
W   W     W     W   W     W      g         a     W
W                                                W
W     W     W     W   W     W                    W
WWWWWWWWWWWWWWWWWWWWWWWWWWWWWWWWWWWWWWWWWWWWWWWWWW