WWWWWWWWWWWWWWWWWWWWWWWWWWWWWWWWWWWWWWWWWWWWWWWWWWWWWWWWWWWWWWWWWWWWWWWWWWWWWWWW
W A    bb      bb      bb      bb      bb      bb      bb      bb      bb      W
W      bb      bb      bb      bb      bb      bb      bb      bb      bb      W
W  m   bb  m   bb  m   bb  m   bb  m   bb  m   bb  m   bb  m   bb  m   bb  m   W
W      bb      bb      bb      bb      bb      bb      bb      bb      bb      W
W      bb      bb      bb      bb      bb      bb      bb      bb      bb      W
WbbbbbbbbbbbbbbbbbbbbbbbbbbbbbbbbbbbbbbbbbbbbbbbbbbbbbbbbbbbbbbbbbbbbbbbbbbbbbbW
WbbbbbbbbbbbbbbbbbbbbbbbbbbbbbbbbbbbbbbbbbbbbbbbbbbbbbbbbbbbbbbbbbbbbbbbbbbbbbbW
W      bb      bb      bb      bb      bb      bb      bb      bb      bb      W
W      bb      bb      bb      bb      bb      bb      bb      bb      bb      W
W  m   bb  m   bb  m   bb  m   bb  m   bb  m   bb  m   bb  m   bb  m   bb  m   W
W      bb      bb      bb      bb      bb      bb      bb      bb      bb      W
W      bb      bb      bb      bb      bb      bb      bb      bb      bb      W
WbbbbbbbbbbbbbbbbbbbbbbbbbbbbbbbbbbbbbbbbbbbbbbbbbbbbbbbbbbbbbbbbbbbbbbbbbbbbbbW
WbbbbbbbbbbbbbbbbbbbbbbbbbbbbbbbbbbbbbbbbbbbbbbbbbbbbbbbbbbbbbbbbbbbbbbbbbbbbbbW
W      bb      bb      bb      bb      bb      bb      bb      bb      bb      W
W      bb      bb      bb      bb      bb      bb      bb      bb      bb      W
W  m   bb  m   bb  m   bb  m   bb  m   bb  m   bb  m   bb  m   bb  m   bb  m   W
W      bb      bb      bb      bb      bb      bb      bb      bb      bb      W
W      bb      bb      bb      bb      bb      bb      bb      bb      bb      W
WbbbbbbbbbbbbbbbbbbbbbbbbbbbbbbbbbbbbbbbbbbbbbbbbbbbbbbbbbbbbbbbbbbbbbbbbbbbbbbW
WbbbbbbbbbbbbbbbbbbbbbbbbbbbbbbbbbbbbbbbbbbbbbbbbbbbbbbbbbbbbbbbbbbbbbbbbbbbbbbW
W      bb      bb      bb      bb      bb      bb      bb      bb      bb      W
W      bb      bb      bb      bb      bb      bb      bb      bb      bb      W
W  m   bb  m   bb  m   bb  m   bb  m   bb  m   bb  m   bb  m   bb  m   bb  m   W
W      bb      bb      bb      bb      bb      bb      bb      bb      bb      W
W      bb      bb      bb      bb      bb      bb      bb      bb      bb      W
WWWWWWWWWWWWWWWWWWWWWWWWWWWWWWWWWWWWWWWWWWWWWWWWWWWWWWWWWWWWWWWWWWWWWWWWWWWWWWWW