WWWWWWWWWWWWWWWWWWWWWWWWWWWWWWWWWWWWWWWWWWWWWWWWWW
W                                                W
W        WWWWWWWWWWWWWWWW                        W
W        W              W                        W
W        W       g      W                        W
W        W                                       W
W        WWWWWWWWWWWWWWWW                        W
W                                                W
W                                                W
W                                                W
W                                                W
W                                                W
W                                                W
W                                                W
W                                                W
W                                                W
W                                                W
W          WWWWWWWWWWWWWWWWWWWWWWW               W
W                                W               W
W                    a           W               W
W          W                     W               W
W          WWWWWWWWWWWWWWWWWWWWWWW               W
W                                                W
W                                                W
W                                                W
W                                                W
W                                                W
W                                                W
W                                                W
W                                                W
W                                                W
W    WWWWWW  W                                   W
W    W       W                                   W
W    W   g   W                                   W
W    W       W                                   W
W    W       W                                   W
W    W   WWWWW                                   W
W                                                W
W                                                W
W                   WWWWWWWWWWWW                 W
W                   W                            W
W                   W     m    W                 W
W                              W                 W
W                   WWWWWWWWWWWW                 W
W                                                W
WWWWWWWWWWWWWWWWWWWWWWWWWWWWWWWWWWWWWWWWWWWWWWWWWW