WWWWWWWWWWWWWWWWWWWWWWWWWWWWWWWWWWWWWWWWWWWWWWWWWWWWWWWWWWWWWWWWWWWWWWWWWWWWWWWWWWW
L   A      L                           W W W                                      W
L          L                           W W W     W                                W
L  L       L          W       W        W W W              W      W       W        W
L          L         WgW     WmW       WWWWW   L         WgW     WmW    WmW       W
W                     W       W        W W W          L   W      W       W        W
W LLLLL                  W             W W W          L             W             W
W                       WmW            W W W                       WmW            W
W                   W    W             W W W                   W    W             W
W                  WaW                 W W W                   aW                 W
W                   W             W    W W W                   W             W    W
W      WmW                        WgW  W W W      WmW                        WgW  W
W       W                          W   W W W       W                          W   W
W                   L     L            W W W                   L     L            W
W                                      W W W                                      W
W              W              W        W W W              W              W        W
W             WgW            WmW       W W W             WgW            WmW       W
W              W              W        W W W              W              W        W
W     L                  W             W W W     L                  W             W
W                       WmW            W W W                       WmW            W
W                   W    W             W W W                   W    W             W
W                  WaW                 W W W                  WaW                 W
W           L       W              W   W W W           L       W              W   W
W                                 WgW  W W W                                 WgW  W
W                                  W   W W W                                  W   W
W                             W        W W W                             W        W
W         A        L         WmW       W W W         A        L         WmW       W
W                             W        W W W                             W        W
W         W                            W W W         W                            W
W        WaW                           W W W        WaW                           W
W         W              W             W W W         W              W             W
W                       WgW            W W W                       WgW            W
W                        W    W        W W W                        W    W        W
W                            WmW       W W W                            WmW       W
W                             W        W W W                             W        W
W              W                       W W W              W                       W
W             WmW                      W W W             WmW                      W
W              W                       W W W              W               L       W
W       L           W                  W W W       L           W                  W
W                  WGW                 W W W                  WGW                 W
W                   W              W   W W W                   W              W   W
W                                 WaW                                        WaW  W
W                                  W                                          W   W
W      W                                          W                               W
W     WaW                                        WaW                              W
W      W            W                             W            W                  W
W                  WgW                                        WgW                 W
W                   W                                          W                  W
W                                                                                 W
W                                                                                 W
W                                                                                 W
WWWWWWWWWWWWWWWWWWWWWWWWWWWWWWWWWWWWWWWWWWWWWWWWWWWWWWWWWWWWWWWWWWWWWWWWWWWWWWWWWWW