WWWWWWWWWWWWWWWWWWWWWWWWWWWWWWWWWWWWWWWW
W     b       A     b       m          W
W Wb  Wbb    Wb   b W W   bb W    b    W
W     W     W       W W       W     W  W
W W   b  g  Wb  bb W W bbbb  W  c   W  W
W W   W     W     W W W W    W     W   W
W Wb bb Wbbb b W W Wb bbb Wb           W
W       W     W   W   W       W        W
Wb  bb W W b b W b  b W bbb W Wb  bb   W
W   W   a     W   W     W W W W     W  W
W W         b    bbbb W W W Wb   bb W  W
W W   W   W       W     W   W     W W  W
W bbbbbbb Wbbbbbb W bbbbbbb Wbb W W  W
W       W       W W   W       Wbb   W  W
W bbbbb Wbbbbbb W bbbbb Wbbbbbb  W
W   W         W W     W   W  W     W  W
W W bbbbbbbb W bbbbbbb W bbbbbbb  W  W
W W       m W W       W W       W  W  W
W bbbbbbbbb W bbbbbbb W bbbbbbbb  W    W
W         W W           W           WW W
WWWWWWWWWWWWWWWWWWWWWWWWWWWWWWWWWWWWWWWW
W   c      W            W   m         W
W bbbbbbb  W  bbbbbbb  W bbbbbbb bbbbbW
W W     W  W  W     W  W        W     WW
W W  g  W  W  W  c  W  Wbb    b W  g  WW
W W     W  W  W     W  W        W     WW
W bbbbbbb  W  bbbbbbb  W bbbbbbb bbbbbWW
W         W           W W              WW
bbbbb bbbb bbbbbbbbb W  bbbbbbbbbb  WW
W     W  W     W      W W      W      WW
W bbb W  W bbb W bbbbbb W bbbb W bbbb WW
W   W    W   W W      W   W    W    W WW
bbbbbbbbb bbbb W bbbb W bbbbbbbb WW W WW
W       W      W W    W       W  WW   WW
W bbbbb bbbbbbbbb W bbbb WbbbbbbbbWWWWW
W     W        W W      W   W W     W  W
W bbbbbbb  bbbb W b  bbbb W W b   bbb WW
W       W  W    W W     W W W          W
bbbbbbbbb  W bbbb bb    b W bbbbbbbbbb W
W         W W           W           W WW
WWWWWWWWWWWWWWWWWWWWWWWWWWWWWWWWWWWWWWWW