WWWWWWWWWWWWWWWWWWWWWWWWWWWWWWWWWWWWWWWWWWWWWWWWWWWWWWWWWWWWWWWWWWWWWWW
W A        a  b      b      b      b      b      b      b      b      W
W             b      b      b      b      b      b      b      b      W
W  m          b  m   b  m   b  m   b  m   b  m   b  m   b  m   b  m   W
W             b      b      b      b      b      b      b      b      W
W             b      b      b      b      b      b      b      b      W
WbbbbbbbbbbbbbbbbbbbbbbbbbbbbbbbbbbbbbbbbbbbbbbbbbbbbbbbbbbbbbbbbbbbbbW
W      b      b      b      b      b      b      b      b      b      W
W      b      b      b      b      b      b      b      b      b      W
W  m   b  m   b  m   b  m   b  m   b  m   b  m   b  m   b  m   b  m   W
W      b      b      b      b      b      b      b      b      b      W
W      b      b      b      b      b      b      b      b      b      W
WbbbbbbbbbbbbbbbbbbbbbbbbbbbbbbbbbbbbbbbbbbbbbbbbbbbbbbbbbbbbbbbbbbbbbW
W      b      b      b      b      b      b      b      b             W
W      b      b      b      b      b      b      b      b             W
W  m   b  m   b  m   b  m   b  m   b  m   b  m   b  m   b   m      m  W
W      b      b      b      b      b      b      b      b             W
W      b      b      b      b      b      b      b      b             W
WbbbbbbbbbbbbbbbbbbbbbbbbbbbbbbbbbbbbbbbbbbbbbbbbbbbbbbbbbbbbbbbbbbbbbW
W      b      b      b      b      b      b      b      b      b      W
W      b      b      b      b      b      b      b      b      b      W
W  m   b  m   b  m   b  m   b  m   b  m   b  m   b  m   b  m   b  m   W
W      b      b      b      b      b      b      b      b      b      W
W      b      b      b      b      b      b      b      b      b      W
WbbbbbbbbbbbbbbbbbbbbbbbbbbbbbbbbbbbbbbbbbbbbbbbbbbbbbbbbbbbbbbbbbbbbbW
W A        a  b      b      b      b      b      b      b      b      W
W             b      b      b      b      b      b      b      b      W
W  m          b  m   b  m   b  m   b  m   b  m   b  m   b  m   b  m   W
W             b      b      b      b      b      b      b      b      W
W             b      b      b      b      b      b      b      b      W
WbbbbbbbbbbbbbbbbbbbbbbbbbbbbbbbbbbbbbbbbbbbbbbbbbbbbbbbbbbbbbbbbbbbbbW
W      b      b      b      b      b      b      b      b      b      W
W      b      b      b      b      b      b      b      b      b      W
W  m   b  m   b  m   b  m   b  m   b  m   b  m   b  m   b  m   b  m   W
W      b      b      b      b      b      b      b      b      b      W
W      b      b      b      b      b      b      b      b      b      W
WbbbbbbbbbbbbbbbbbbbbbbbbbbbbbbbbbbbbbbbbbbbbbbbbbbbbbbbbbbbbbbbbbbbbbW
W      b      b      b      b      b      b      b      b      m      W
W      b      b      b      b      b      b      b      b  a         mW
W  m   b  m   b  m   b  m   b  m   b  m   b  m   b  m   b         m   W
W      b      b      b      b      b      b      b      b  g          W
W      b      b      b      b      b      b      b      b      m    m W
Wbbbbbbbbbbbbbbbbbbbbbbbbbbbbbbbbbbbbbbbbbbbbbbbbbbbbbbbb             W
W      b      b      b      b      b      b      b      b     m     m W
W      b      b      b      b      b      b      b      b             W
W  m   b  m   b  m   b  m   b  m   b  m   b  m   b  m   b  m    m     W
W      b      b      b      b      b      b      b      b             W
W      b      b      b      b      b      b      b      b    g     a  W
WWWWWWWWWWWWWWWWWWWWWWWWWWWWWWWWWWWWWWWWWWWWWWWWWWWWWWWWWWWWWWWWWWWWWWW