WWWWWWWWWWWWWWWWWWWWWWWWWWWWWWWWWWWWWWWWW
W                 WWWWW                 W
W                 WWWWW                 W
W      a W        WWWWW      a W        W
W        W        WWWWW        W        W
W      WWWWWW     WWWWW      WWWWWW     W
W     m  W        WWWWW     m  W        W
W        W  g     WWWWW        W  g     W
W    A            WWWWW    A            W
W                 WWWWW                 W
WWWWWWWWWWWWWWWWWWWWWWWWWWWWWWWWWWWWWWWWW
WWWWWWWWWWWWWWWWWWWWWWWWWWWWWWWWWWWWWWWWW
WWWWWWWWWWWWWWWWWWWWWWWWWWWWWWWWWWWWWWWWW
WWWWWWWWWWWWWWWWWWWWWWWWWWWWWWWWWWWWWWWWW
WWWWWWWWWWWWWWWWWWWWWWWWWWWWWWWWWWWWWWWWW
W        W       WWWWWWW        W       W
W   a    W       WWWWWWW   a    W       W
W        W  g    WWWWWWW        W  g    W
W                WWWWWWW                W
WWWWWW       WWWWWWWWWWWWWWWW       WWWWW
W                WWWWWWW                W
W        W    m  WWWWWWW        W    m  W
W    A   W       WWWWWWW    A   W       W
W        W       WWWWWWW        W       W
WWWWWWWWWWWWWWWWWWWWWWWWWWWWWWWWWWWWWWWWW
WWWWWWWWWWWWWWWWWWWWWWWWWWWWWWWWWWWWWWWWW
WWWWWWWWWWWWWWWWWWWWWWWWWWWWWWWWWWWWWWWWW
WWWWWWWWWWWWWWWWWWWWWWWWWWWWWWWWWWWWWWWWW
