WWWWWWWWWWWWWWWWWWWWWWWWWWWW
W                          W
W   A                      W
W                          W
W             W            W
W             W            W
W             W            W
W             W            W
W       WWWWWWWWWWWWWW     W
W             W            W
W             W  a         W
W             W            W
W             W            W
W                          W
W                          W
W                          W
W                          W
W      WWWWWWWWWWWW        W
W              a           W
W                          W
W             W            W
W             W            W
WWWWWWWWW          WWWWWWWWW
W                          W
W                          W
W                          W
W             W            W
W             W            W
W             W            W
W             W   a        W
W             W            W
WWWWWWWWWWWWWWWWWWWWWWWWWWWW