####################################################
#      A        A         A         A         A    #
#                                                  #
#                                                  #
#                                                  #
#         ##########                               #
#         #  g g g #                               #
#         #        #                               #
#                                                  #
#                                                  #
#                                ##########        #
#                                #  c c c #        #
#                                #        #        #
#         #############                            #
#         #  a  a  a  #                            #
#         #           #                            #
#                                                  #
#                                                  #
#                                                  #
#                                                  #
####################################################
####################################################
#                                                  #
#                         A                        #
#                                                  #
#         ##########                               #
#         #  g g g #                               #
#         #        #                               #
#                                ##########        #
#                                #  c c c #        #
#                                #        #        #
#         #############                            #
#         #  a  a  a  #                            #
#         #           #                            #
#                                                  #
####################################################