###################################################################
#                                 c                               #                                         
#                                                                 #
# a A                                                        A  g #
#                                                                 #
#                                 c                               #
###################################################################