WWWWWWWWWWWWWWWWWWWWWW
WWW a WWWW  WWWWWWWWWW
WWWWW  WWW  WWWWWWWWWW
WWWWWW  WW  WWWWWWWWWW
WWWWWWWW    WWWWWWWWWW
Wg       A  A      c W
WWWWWWWWWW    WWWWWWWW
WWWWWWWWWW  WW gWWWWWW
WWWWWWWWWW  WWWW  WWWW
WWWWWWWWWW cWWWWWW  WW
WWWWWWWWWWWWWWWWWWWWWW
Wg       cWWWWWWWWWWWW
W         WWWWWWWWWWWW
W         WWWWWWWWWWWW
W         WWWWWWWWWWWW
W    A    WWWWWWWWWWWW
W         WWWWWWWWWWWW
W         WWWWWWWWWWWW
W         WWWWWWWWWWWW
W    a    WWWWWWWWWWWW
WWWWWWWWWWWWWWWWWWWWWW