########################################################################################
###           ########################       ###########################################
######            ####################   g   ###########################################
######       c     ###################       ###########################################
#########            #################       #######################           #########
###########           ################       ####################     c       ##########
############           ###############       ################              #############
#############          ###############       #############             #################
################         #############       ###########           #####################
##################         ###########       #########           #######################
####################         #########       #######           #########################
######################         #######       ######         ############################
########################        ######       ####        ###############################
##########################         ###       ##       ##################################
#############################        #       #       ###################################
#                                                                                      #
#                    g                AAAA                                    g        #
#                                                                                      #
###############################      #       #     #####################################
############################       ###       #       ###################################
############################      ####       ###        ################################
#########################       ######       ####        ###############################
######################         #######       ######         ############################
####################         #########       ########           ########################
##################         ##########        ###########           #####################
################         #############       ##############          ###################
##############         ###############       #################         c ###############
###########  c   a   #################   a   #####################  g       ############
######              ##################       ##########################          #######
########################################################################################
