WWWWWWWWWWWWWWWWWWWWWWWWWWWWWWWWWWWWWWWWWWWWWWWWWWWWWWWWWWWWWWWWWWWWWWWWWWWWWWWWWWWWWWWW
WWW           WWWWWWWWWWWWWWWWWWWWWWWW       WWWWWWWWWWWWWWWWWWWWWWWWWWWWWWWWWWWWWWWWWWW
WWWWWW            WWWWWWWWWWWWWWWWWWWW   g   WWWWWWWWWWWWWWWWWWWWWWWWWWWWWWWWWWWWWWWWWWW
WWWWWW       c     WWWWWWWWWWWWWWWWWWW       WWWWWWWWWWWWWWWWWWWWWWWWWWWWWWWWWWWWWWWWWWW
WWWWWWWWW            WWWWWWWWWWWWWWWWW       WWWWWWWWWWWWWWWWWWWWWWW           WWWWWWWWW
WWWWWWWWWWW           WWWWWWWWWWWWWWWW       WWWWWWWWWWWWWWWWWWWW     c       WWWWWWWWWW
WWWWWWWWWWWW           WWWWWWWWWWWWWWW       WWWWWWWWWWWWWWWW              WWWWWWWWWWWWW
WWWWWWWWWWWWW          WWWWWWWWWWWWWWW       WWWWWWWWWWWWW             WWWWWWWWWWWWWWWWW
WWWWWWWWWWWWWWWW         WWWWWWWWWWWWW       WWWWWWWWWWW           WWWWWWWWWWWWWWWWWWWWW
WWWWWWWWWWWWWWWWWW         WWWWWWWWWWW       WWWWWWWWW           WWWWWWWWWWWWWWWWWWWWWWW
WWWWWWWWWWWWWWWWWWWW         WWWWWWWWW       WWWWWWW           WWWWWWWWWWWWWWWWWWWWWWWWW
WWWWWWWWWWWWWWWWWWWWWW         WWWWWWW       WWWWWW         WWWWWWWWWWWWWWWWWWWWWWWWWWWW
WWWWWWWWWWWWWWWWWWWWWWWW        WWWWWW       WWWW        WWWWWWWWWWWWWWWWWWWWWWWWWWWWWWW
WWWWWWWWWWWWWWWWWWWWWWWWWW         WWW       WW       WWWWWWWWWWWWWWWWWWWWWWWWWWWWWWWWWW
WWWWWWWWWWWWWWWWWWWWWWWWWWWWW        W       W       WWWWWWWWWWWWWWWWWWWWWWWWWWWWWWWWWWW
W                                                                                      W
W                    g                AAAA                                    g        W
W                                                                                      W
WWWWWWWWWWWWWWWWWWWWWWWWWWWWWWW      W       W     WWWWWWWWWWWWWWWWWWWWWWWWWWWWWWWWWWWWW
WWWWWWWWWWWWWWWWWWWWWWWWWWWW       WWW       W       WWWWWWWWWWWWWWWWWWWWWWWWWWWWWWWWWWW
WWWWWWWWWWWWWWWWWWWWWWWWWWWW      WWWW       WWW        WWWWWWWWWWWWWWWWWWWWWWWWWWWWWWWW
WWWWWWWWWWWWWWWWWWWWWWWWW       WWWWWW       WWWW        WWWWWWWWWWWWWWWWWWWWWWWWWWWWWWW
WWWWWWWWWWWWWWWWWWWWWW         WWWWWWW       WWWWWW         WWWWWWWWWWWWWWWWWWWWWWWWWWWW
WWWWWWWWWWWWWWWWWWWW         WWWWWWWWW       WWWWWWWW           WWWWWWWWWWWWWWWWWWWWWWWW
WWWWWWWWWWWWWWWWWW         WWWWWWWWWW        WWWWWWWWWWW           WWWWWWWWWWWWWWWWWWWWW
WWWWWWWWWWWWWWWW         WWWWWWWWWWWWW       WWWWWWWWWWWWWW          WWWWWWWWWWWWWWWWWWW
WWWWWWWWWWWWWW         WWWWWWWWWWWWWWW       WWWWWWWWWWWWWWWWW         c WWWWWWWWWWWWWWW
WWWWWWWWWWW  c   a   WWWWWWWWWWWWWWWWW   a   WWWWWWWWWWWWWWWWWWWWW  g       WWWWWWWWWWWW
WWWWWW              WWWWWWWWWWWWWWWWWW       WWWWWWWWWWWWWWWWWWWWWWWWWW          WWWWWWW
WWWWWWWWWWWWWWWWWWWWWWWWWWWWWWWWWWWWWWWWWWWWWWWWWWWWWWWWWWWWWWWWWWWWWWWWWWWWWWWWWWWWWWWW
