WWWWWWWWWWWWWWWWWWWW
WWWWWWWW c  WWWWWWWW
WWWWWWWW    WWWWWWWW
WWWWWWWW    WWWWWWWW
WWWWWWWW    WWWWWWWW
WWWWWWWW    WWWWWWWW
WWWWWWWW    WWWWWWWW
WWWWWWWW    WWWWWWWW
W                  W
Wg        A       gW
W                  W
WWWWWWWW    WWWWWWWW
WWWWWWWW    WWWWWWWW
WWWWWWWW    WWWWWWWW
WWWWWWWW    WWWWWWWW
WWWWWWWW    WWWWWWWW
WWWWWWWW    WWWWWWWW
WWWWWWWW a  WWWWWWWW
WWWWWWWWWWWWWWWWWWWW