########################################
#  g   # c  #### a ##  g   # c  #### a #
##     #    ###   ####     #    ###   ##
####             #######             ###
####            ########            ####
#####          ##########          #####
######        ############        ######
#                  ##                  #
#        AA        ##        AA       #
#                  ##                  #
#                  ##                  #
#####          ##########          #####
#                  ##                  #
#                  ##                  #
#                  ##                  #
#      #    #      ##      #    #      #
#      #    #      ##      #    #      #
#  g   #  c #  a   ##   g  # c  #  a   #
########################################