####################
######## c  ########
########    ########
########    ########
########    ########
########    ########
########    ########
########    ########
#                  #
#g        A       g#
#                  #
########    ########
########    ########
########    ########
########    ########
########    ########
########    ########
######## a  ########
####################