WWWWWWWWWWWWWWWWWWWWWWWWWWWWWWWWWWWWWWWW
W  g   W c  WWWW a WW  g   W c  WWWW a W
WW     W    WWW   WWWW     W    WWW   WW
WWWW   W    WW   WWWWWWW   W    WW   WWW
WWWW   W    W   WWWWWWWW   W    W   WWWW
WWWWW          WWWWWWWWWW          WWWWW
WWWWWW        WWWWWWWWWWWW        WWWWWW
W                  WW                  W
W        AA        WW        AA       W
W                  WW                  W
W                  WW                  W
WWWWWW        WWWWWWWWWWWW        WWWWWW
W                  WW                  W
W      W    W      WW      W    W      W
W      W    W      WW      W    W      W
W      W    W      WW      W    W      W
W      W    W      WW      W    W      W
W  g   W  c W  a   WW   g  W c  W  a   W
WWWWWWWWWWWWWWWWWWWWWWWWWWWWWWWWWWWWWWWW