WWWWWWWWWWWWWWWWWWWWWWWWWWWWWWWWWWWWWWWWWWWWWWWW
W                    WWWWWW              a     W
W                    WWWWWW    g               W
W   a                WWWWWW                    W
W             g      WWWWWW                    W
W                    WWWWWW                    W
W                    WWWWWW                    W
W                    WWWWWW                    W
W   A          m     WWWWWW              m     W
W                    WWWWWW                    W
W                    WWWWWW    A               W
WWWWWWWWWWWWWWWWWWWWWWWWWWWWWWWWWWWWWWWWWWWWWWWW
WWWWWWWWWWWWWWWWWWWWWWWWWWWWWWWWWWWWWWWWWWWWWWWW
WWWWWWWWWWWWWWWWWWWWWWWWWWWWWWWWWWWWWWWWWWWWWWWW
WWWWWWWWWWWWWWWWWWWWWWWWWWWWWWWWWWWWWWWWWWWWWWWW
W                    WWWWW                     W
W                    WWWWW                     W
W       m            WWWWW    a                W
W             A      WWWWW             A       W
W                    WWWWW                     W
W                    WWWWW                     W
W      g             WWWWW      g              W
W             a      WWWWW                     W
W                    WWWWW    m                W
W                    WWWWW                     W
WWWWWWWWWWWWWWWWWWWWWWWWWWWWWWWWWWWWWWWWWWWWWWWW
WWWWWWWWWWWWWWWWWWWWWWWWWWWWWWWWWWWWWWWWWWWWWWWW
WWWWWWWWWWWWWWWWWWWWWWWWWWWWWWWWWWWWWWWWWWWWWWWW
WWWWWWWWWWWWWWWWWWWWWWWWWWWWWWWWWWWWWWWWWWWWWWWW