WWWWWWWWWWWWWWWWWWWWWW
W                    W
W                    W
W   a                W
W             g      W
W                    W
W                    W
W                    W
W   A          m     W
W                    W
W                    W
WWWWWWWWWWWWWWWWWWWWWW
WWWWWWWWWWWWWWWWWWWWWW
WWWWWWWWWWWWWWWWWWWWWW
WWWWWWWWWWWWWWWWWWWWWW
W                    W
W                    W
W        a           W
W            A       W
W                    W
W                    W
W                    W
W   m          g     W
W                    W
W                    W
WWWWWWWWWWWWWWWWWWWWWW
WWWWWWWWWWWWWWWWWWWWWW
WWWWWWWWWWWWWWWWWWWWWW
WWWWWWWWWWWWWWWWWWWWWW
WWWWWWWWWWWWWWWWWWWWWW
W                    W
W                    W
W       m            W
W             A      W
W                    W
W                    W
W      g             W
W             a      W
W                    W
W                    W
WWWWWWWWWWWWWWWWWWWWWW
WWWWWWWWWWWWWWWWWWWWWW
WWWWWWWWWWWWWWWWWWWWWW
WWWWWWWWWWWWWWWWWWWWWW
WWWWWWWWWWWWWWWWWWWWWW
W                    W
W                    W
W   a         A      W
W                    W
W                    W
W           g        W
W                    W
W   m                W
W                    W
W                    W
WWWWWWWWWWWWWWWWWWWWWW