##################################################
#g                                               #
#      A           A           A        A        #
#                                                #
#                                                #
#            A           A          A            ##
#                                                #
#      A           A           A         A       #
#                                                #
#                                                #
#            A           A          A            #
#                                                #
#                                                #
#            g                     g             #
#                                                #
#                                                #
#                                                #
#                        #                       #
#                     a  #  c                    #
#                        #                       #
#                  #############                 #
#                        #                       #
#                    c   #  a                    #
#                        #                       #
#                                                #
#                                                #
#                                                #
#            g                      g            #
#                                                #
#                                                #
#                                                #
#      A           A           A         A       #
#                                                #
#                                                #
#            A           A           A           #
#                                                #
#      A           A           A          A      #
#                                                #
#                                                #
#            A           A          A            #
#                                                #
#                                                #
#                                                #
#                                                #
##################################################