WWWWWWWWWWWWWWWWWWWWWWWWWWWWWWWWWWWWWWWWWWWWWWWWWWWWWWWWWWWWWWWWWWWWWWWWWWWWWWWWWWWWWWWWWWWWWWWWWWWWWWWWWWWWWWWWWWWWWWWWWWWWWWWWWWWWWWWWWWWWWWWWWWWWWWWWWWWWWWWWWWWWWWWWWWWWWWWWWWWWWWWWWWWWWWWWWWWWWWWWWWWWWWWWWWWWWWWWWWWWWWWWWWWWWWWWWWWWWWWWWWWWWWWWWWWWWWWWWWWWWWWWWWWWWWWWWWWWWWWWWWWWWWWWWWWWWWWWWWWWWWWWWWWWWWWWWWWWWWWWWWWWWWWWW
WWWWW  a  WWWWW  a  W WWW     WWWWWWWW  a  WWWWW     WWWWWWWWWW     WWWWWWWW  a  WWWWWWWWWW  a  WWWWWWWWWW     WWWWWWWW  a  WWWWWWWWWW  a  WWWWWWWWWW     WWWWWWWW  a  WWWWWWWWWW  a  WWWWWWWWWW     WWWWWWWW  a  WWWWWWWWWW     WWWWWWWWWW     WWWWWWWW  a  WWWWWWWWWW  a  WWWWWWWWWW     WWWWWWWW     WWWWWWWWWW     WWWWWWWWWW  a  WWW
WWWWWm   gWWWWm     g WWW     WWWWWWWg     mWWWW     WWWWWWWWWW     WWWWWWWg     mWWWWWWWWm     gWWWWWWWWW     WWWWWWWg     mWWWWWWWWg     mWWWWWWWWW     WWWWWWWm     gWWWWWWWWm     gWWWWWWWWW     WWWWWWWg     mWWWWWWWWW     WWWWWWWWWW     WWWWWWWg     mWWWWWWWWm     gWWWWWWWWW     WWWWWWWW     WWWWWWWWWW     WWWWWWWWWg     mWW
WWWWW     WWWWW     WWWWW     WWWWWWWW     WWWWW     WWWWWWWWWW     WWWWWWWW     WWWWWWWWWW     WWWWWWWWWW     WWWWWWWW     WWWWWWWWWW     WWWWWWWWWW     WWWWWWWW     WWWWWWWWWW     WWWWWWWWWW     WWWWWWWW     WWWWWWWWWW     WWWWWWWWWW     WWWWWWWW     WWWWWWWWWW     WWWWWWWWWW     WWWWWWWW     WWWWWWWWWW     WWWWWWWWWW     WWW
WWWWW     WWWWW     WWWWW     WWWWWWWW     WWWWW     WWWWWWWWWW     WWWWWWWW     WWWWWWWWWW     WWWWWWWWWW     WWWWWWWW     WWWWWWWWWW     WWWWWWWWWW     WWWWWWWW     WAWWWWWWWW     WWWWWWWWWW     WWWWWWWW     WWWWWWWWWW     WWWWWWWWWW     WWWWWWWW     WWWWWWWWWW     WWWWWWWWWW     WWWWWWWW     WAWWWWWWWW     WWWWWWWWWW     WWW
WWWWW    LWWWWW    LWWWWW     WWWWWWWW    LWWWWW     WWWWWWWWWW     WWWWWWWW    LWWWWWWWWWW    LWWWWWWWWWW     WWWWWWWW    LWWWWWWWWWW    LWWWWWWWWWW     WWWWWWWW    LWWWWWWWWWW    LWWWWWWWWWW     WWWWWWWW    LWWWWWWWWWW     WWWWWWWWWW     WWWWWWWW    LWWWWWWWWWW    LWWWWWWWWWW     WWWWWWWW     WWWWWWWWWW     WWWWWWWWWW    LWWW
W                                                                                                                                                                                                                                                                                                                                       W
WA                                                                                                                                                                                                                                                                                                                                     AW
W                                                                                                                                                                                                                                                                                                                                       W
WWWWW     WWWWW     WWWWW    LWWWWWWWW     WWWWW    LWWWWWWWWWW    LWWWWWWWW     WWWWWWWWWW     WWWWWWWWWW    LWWWWWWWW     WWWWWWWWWW     WWWWWWWWWW    LWWWWWWWW     WWWWWWWWWW     WWWWWWWWWW    LWWWWWWWW     WWWWWWWWWW    LWWWWWWWWWW    LWWWWWWWW     WWWWWWWWWW     WWWWWWWWWW    LWWWWWWWW    LWWWWWWWWWW    LWWWWWWWWWW     WWW
WWWWW     WWWWW     WWWWW     WWWWWWWW     WWWWW     WWWWWWWWWW     WWWWWWWW     WWWWWWWWWW     WWWWWWWWWW     WWWWWWWW     WWWWWWWWWW     WWWWWWWWWW     WWWWWWWW     WWWWWWWWWW     WWWWWWWWWW     WWWWWWWW     WWWWWWWWWW     WWWWWWWWWW     WWWWWWWW     WWWWWWWWWW     WWWWWWWWWW     WWWWWWWW     WWWWWWWWWW     WWWWWWWWWW     WWW
WWWWW     WWWWW     WWWWW     WWWWWWWW     WWWWW     WWWWWWWWWW     WWWWWWWW     WWWWWWWWWW     WWWWWWWWWW     WWWWWWWW     WWWWWWWWWW     WWWWWWWWWW     WWWWWWWW     WWWWWWWWWW     WWWWWWWWWW     WWWWWWWW     WWWWWWWWWW     WWWWWWWWWW     WWWWWWWW     WWWWWWWWWW     WWWWWWWWWW     WWWWWWWW     WWWWWWWWWW     WWWWWWWWWW     WWW
WWWWW     WWWWW     WWWWg     mWWWWWWW     WWWWm     gWWWWWWWWg     mWWWWWWW     WWWWWWWWWW     WWWWWWWWWg     mWWWWWWW     WWWWWWWWWW     WWWWWWWWWg     mWWWWWWW     WWWWWWWWWW     WWWWWWWWWg     mWWWWWWW     WWWWWWWWWm     gWWWWWWWWg     mWWWWWWW     WWWWWWWWWW     WWWWWWWW g     mWWWWWWm     gWWWWWWWWm     gWWWWWWWWW     WWW
WWWWW     WWWWW     WWWWW  a  WWWWWWWW     WWWWW  a  WWWWWWWWWW  a  WWWWWWWW     WWWWWWWWWW     WWWWWWWWWW  a  WWWWWWWW     WWWWWWWWWW     WWWWWWWWWW  a  WWWWWWWW     WWWWWWWWWW     WWWWWWWWWW  a  WWWWWWWW     WWWWWWWWWW  a  WWWWWWWWWW  a  WWWWWWWW     WWWWWWWWWW     WWWWWWWWWW  a  WWWWWWWW  a  WWWWWWWWWW  a  WWWWWWWWWW     WWW
WWWWWWWWWWWWWWWWWWWWWWWWWWWWWWWWWWWWWWWWWWWWWWWWWWWWWWWWWWWWWWWWWWWWWWWWWWWWWWWWWWWWWWWWWWWWWWWWWWWWWWWWWWWWWWWWWWWWWWWWWWWWWWWWWWWWWWWWWWWWWWWWWWWWWWWWWWWWWWWWWWWWWWWWWWWWWWWWWWWWWWWWWWWWWWWWWWWWWWWWWWWWWWWWWWWWWWWWWWWWWWWWWWWWWWWWWWWWWWWWWWWWWWWWWWWWWWWWWWWWWWWWWWWWWWWWWWWWWWWWWWWWWWWWWWWWWWWWWWWWWWWWWWWWWWWWWWWWWWWWWWWWWWWWW

