WWWWWWWWWWW
Wg       gW
W         W
W         W
W         W
W    A    W
W         W
W         W
W         W
W    a    W
WWWWWWWWWWW
