WWWWWWWWWWWWWWWWWWWWWWWWWWWWWWWWWWWWWWWW
W         A        WW          A       W
W                  WW                  W
W                  WW                  W
W                  WW                  W
W                  WW                  W
W   g     c    a   WW    g W c  W  a   W
WWWWWWWWWWWWWWWWWWWWWWWWWWWWWWWWWWWWWWWW
W         A        WW        A         W
W                  WW                  W
W                  WW                  W
W                  WW                  W
W                  WW      W    W      W
W      W    W      WW      W    W      W
W  g   W  c W  a   WW  g   W c  W  a   W
WWWWWWWWWWWWWWWWWWWWWWWWWWWWWWWWWWWWWWWW
W         A        WW       A          W
W                  WW                  W
W                  WW      W    W      W
W      W    W      WW      W    W      W
W      W    W      WW      W    W      W
W      W    W      WW      W    W      W
W  g   W  c W  a   WW   g  W  c W   a  W
WWWWWWWWWWWWWWWWWWWWWWWWWWWWWWWWWWWWWWWW