########################################
#         A        ##          A       #
#                  ##                  #
#                  ##                  #
#                  ##                  #
#                  ##                  #
#   g     c    a   ##    g # c  #  a   #
########################################
#         A        ##        A         #
#                  ##                  #
#                  ##                  #
#                  ##                  #
#                  ##      #    #      #
#      #    #      ##      #    #      #
#  g   #  c #  a   ##  g   # c  #  a   #
########################################
#         A        ##       A          #
#                  ##                  #
#                  ##      #    #      #
#      #    #      ##      #    #      #
#      #    #      ##      #    #      #
#      #    #      ##      #    #      #
#  g   #  c #  a   ##   g  #  c #   a  #
########################################