WWWWWWWWWWWWWWWWWWWWWWWWWWWWWWWWWWWWWWWWWWWWWWWWWWWWWWWWWWWWWWWWWWWWWWWWWWWWWWWWWWWWWWWWWWWWWWWWWWWWWWWWWWWWWWWWWWWWWWWWWWWWWWWWWWWWWWW
W                W              W W                W              W W                            g  W W                             m W
W   A            W              W W   A            W              W W   A                           W W   A                           W
W                W    g         W W                W              W W                W             W W                                W
W                W              W W                W              W W                W              W W                               W
W                W              W W                W              W W       W        W              W W                               W
W                               W W                W              W W       W        W              W W                               W
W                               W W       W        W  g           W W       W        W  g           W W                               W
W   a                           W W   a   W        W              W W    m  W        W              W W   a                        g  W
WWW                             W WWWWWWWW         WWWWWW        W WWWWWWWWWW      WWWWWWWWWWWWWWWWWWWWWWWWWWW       WWWWWWWWWWWWWWWWWW
W                               W W                               W W                               W W                               W
W                               W W                               W W  m                            W W    a                          W
W                               W W                               W W               a               W W          W      WWWWWWW       W
W                           WWWWW W                      WWWWWWWWWW W                      WWWWWWWWWW W          W           WWWWWWWWWW
W                               W W                               W W                      W        W W          W m     g   W        W
W                          m    W W                          m    W W                               W W          WWWWWWWWWWWWW        W
W                               W W                               W W                              gW W                               W
WWWWWWWWWWWWWWWWWWWWWWWWWWWWWWWWWWWWWWWWWWWWWWWWWWWWWWWWWWWWWWWWWWWWWWWWWWWWWWWWWWWWWWWWWWWWWWWWWWWWWWWWWWWWWWWWWWWWWWWWWWWWWWWWWWWWWWW
WWWWWWWWWWWWWWWWWWWWWWWWWWWWWWWWWWWWWWWWWWWWWWWWWWWWWWWWWWWWWWWWWWWWWWWWWWWWWWWWWWWWWWWWWWWWWWWWWWWWWWWWWWWWWWWWWWWWWWWWWWWWWWWWWWWWWWW
W a              W           m  W W                W              W W                W              W W                W              W
W   A            W        WWWWWWW W   A            W              W W   A            W              W W   A            W              W
W                W              W W                W              W W                W              W W                W              W
W                W              W W                W              W W                W              W W                W              W
W                W              W W                W              W W                W              W W                W              W
W       W        W              W W                W              W W                W              W W                W   g          W
W       W        W  g           W W       W        W  g           W W                W  g           W W                               W
W   m   W        W              W W   a   W        W              W W   m                           W W  a                            W
WWWWWWWWW        WWWW           W WWWWWWWW         WWWWWW     WWWWW WWWWWWWWWW                      W WWWWWWWWWW       WWWWWWWWWWWWWWWW
W m W                            W W                               W W                               W W                         Wm   W
W                               W W                               W W                               W W                         W     W
W                               W W                               W W                               W W                               W
W  W                       WWWWWW W                      WWWWWWWWWW W                    WWWWWWWWWWWW W                      WWWWWWWWWW
W  W                            W WWWW                  W        W W                               W WW                     W         W
Wa W                      m     W Wm                         m    W W                          a    W Wm                        m     W
WWWWWWW                WWWWWWWW W W                               W W                               W W                               W
Wg                           g  W W                               W W                               W W          W                    W
WWWWWWWWWWWWWWWWWWWWWWWWWWWWWWWWWWWWWWWWWWWWWWWWWWWWWWWWWWWWWWWWWWWWWWWWWWWWWWWWWWWWWWWWWWWWWWWWWWWWWWWWWWWWWWWWWWWWWWWWWWWWWWWWWWWWWWW
WWWWWWWWWWWWWWWWWWWWWWWWWWWWWWWWWWWWWWWWWWWWWWWWWWWWWWWWWWWWWWWWWWWWWWWWWWWWWWWWWWWWWWWWWWWWWWWWWWWWWWWWWWWWWWWWWWWWWWWWWWWWWWWWWWWWWWW
W             W W             W W             W W             W W      W      W W             W W             W W             WWWWWWWWW
W  A      g   W W  A          W W          A  W W   g      A  W W  A   W      W W  A          W W          A  W W         A   WWWWWWWWW
W             W W             W W             W W             W W      W      W W             W W             W W             WWWWWWWWW
W   m    a    W W         g   W W   g         W W             W W      W  g   W W         g   W W   g         W W             WWWWWWWWW
WWWWWWWWWWWWWWW W             W W      W      W W      W      W W             W W      W      W W      W      W W      W      WWWWWWWWW
W A      g     W W  m   W      W W      W   m  W W      W   m  W W  m          W W  m   W      W W      W   m  W W      W   m WWWWWWWWW
W              W WWWWWWWW      W W      WWWWWWWW W      WWWWWWWW W WWWWWW      WWWWWWWWWW    W W         WWWWWWW     WWWWWWWWWWWWWWWWWW
W   m      a   W              W W             W W      W      W W             W W              W W             W W      W     WWWWWWWWW
W              WW W             W W             W W      W      W W             W W             W W             W W      W    WWWWWWWWW
WWWWWWWWWWWWWW W             W W             W W         a   W W             W W             W W             W W      W  a    WWWWWWWWW
W  m   a   g  W W  a   W      W W      W  a   W W             W W  a          W W  a   W      W W       W  a  W W             WWWWWWWWW
W             W W      W      W W      W      W W             W W      W      W W      W      W W       W     W W    g        WWWWWWWWW
W A           W W      WWWWWWWW WWWWWWWW      W WWWWW         W W      WWWWWWWW W      WWWWWWWW W       W WWWWW               WWWWWWWWW
WWWWWWWWWWWWWWWWWWWWWWWWWWWWWWWWWWWWWWWWWWWWWWWWWWWWWWWWWWWWWWWWWWWWWWWWWWWWWWWWWWWWWWWWWWWWWWWWWWWWWWWWWWWWWWWWWWWWWWWWWWWWWWWWWWWWWWW
W A            W  A             W m         W m W                 W                        a  Wa                             gWWWWWWWWW
W            g W               WW               W   A             W W      A          WWWWWWW W                               WWWWWWWWW
W              W              g W               W                 W W                         W                               WWWWWWWWW
W              W W              W  A            W                 W W                         W                               WWWWWWWWW
W m            W m              WWWW            W                 W W   W                     W               A               WWWWWWWWW
W              W               WW g             W        W        W W   W                     W                               WWWWWWWWW
W           a  W               aW             a W    g   W    a   W W   W          WWWWWWWWWWWW                               WWWWWWWWW
W              W                W            W  W        W        W W m W                  g  W                              mWWWWWWWWW
WWWWWWWWWWWWWWWWWWWWWWWWWWWWWWWWWWWWWWWWWWWWWWWWWWWWWWWWWWWWWWWWWWWWWWWWWWWWWWWWWWWWWWWWWWWWWWWWWWWWWWWWWWWWWWWWWWWWWWWWWWWWWWWWWWWWWWW