WWWWWWWWWWWWWWWWWWWWWWWWWWWWWWWWWWWWWWWWWWWWWWWWWWWWWWWWWWWWWWWWWWWWWWWWWWWWWWWWWWWWWWWWWWWWWWWWWWWWWWWWWWWWWWWWWWWWWWWWWWWWWWWWWWWWWWW
W      W              W W      W              W W                 g  W W                             m W            a  W              W
W   A  W          g   W W   A  W              W W   A     m          W W   A                           W               W              W
W      W    g         W W      W        g     W W                    W W                               W               W g            W
W                     W W                     W W                    W W                               W               WWWWW          W
W                     W W                     W W                    W W                               W               W              W
W                     W W                     W W                    W W                               Wg              W              W
W                     W W                     W W       W           gW W                               W               W              W
W   a                 W W   a  W              W W    m  W            W W   a                        g  W               W              W
WWW                   W WWWWWW                W WWWWWWWWW        WWWWWWWWWWWWWWWW        WWWWWWWWWWWWWWW               W      A       W
W  a                  W W                     W W  m                 W W    a                          W               W              W
W                     W W                     W W               a    W W          W      WWWWWWW       W            m  W         WWWWWW
W                 WWWWW W                WWWWWW W               WWWWWW W          W           WWWWWWWWWW               W            m W
W                     W W                     W W                    W W          W m     g   W        W               WWWW           W
W                m    W W                m    W W                    W W          WWWWWWWWWWWWW        W               W a            W
W                     W W                     W W                   gW W                               W               W              W
WWWWWWWWWWWWWWWWWWWWWWWWWWWWWWWWWWWWWWWWWWWWWWWWWWWWWWWWWWWWWWWWWWWWWWWWWWWWWWWWWWWWWWWWWWWWWWWWWWWWWWWW  A            W              W
WWWWWWWWWWWWWWWWWWWWWWWWWWWWWWWWWWWWWWWWWWWWWWWWWWWWWWWWWWWWWWWWWWWWWWWWWWWWWWWWWWWWWWWWWWWWWWWWWWWWWWWWWWWWWWWWWWWWWWWWWWWWWWWWWWWWWWW
W a              W           m  W W                W              W W                W              W W                W              W
W   A            W        WWWWWWW W   A            W              W W   A            W              W W   A            W              W
W                W              W W                W              W W                W              W W                W              W
W                W              W W                W              W W                W              W W                W              W
W                W              W W                W              W W            m   W              W W                W              W
W       W        W              W W                W              W W                W              W W                W   g          W
W       W        W  g           W W       W        W  g           W W                W  g           W W                               W
W   m   W        W              W W   a   W        W              W W   m                           W W  a                            W
WWWWWWWWW        WWWW           W WWWWWWWW         WWWWWW     WWWWW WWWWWWWWWW                      W WWWWWWWWWW       WWWWWWWWWWWWWWWW
W m W                            W W                               W W                              W W                           m   W
W                               W W                               W W         g                     W W                         W     W
W                               W W                               W W                             a W W                               W
W  W                       WWWWWW W                      WWWWWWWWWW W                    WWWWWWWWWWWW W                      WWWWWWWWWW
W  W                            W WWWW                  W        W W                               W WW                     W         W
Wa W                      m     W Wm                         m    W W                          a    W Wm                        m     W
WWWWWWW                WWWWWWWW W W                               W W                               W W                               W
Wg                           g  W W                               W W                               W W          W                    W
WWWWWWWWWWWWWWWWWWWWWWWWWWWWWWWWWWWWWWWWWWWWWWWWWWWWWWWWWWWWWWWWWWWWWWWWWWWWWWWWWWWWWWWWWWWWWWWWWWWWWWWWWWWWWWWWWWWWWWWWWWWWWWWWWWWWWWW
WWWWWWWWWWWWWWWWWWWWWWWWWWWWWWWWWWWWWWWWWWWWWWWWWWWWWWWWWWWWWWWWWWWWWWWWWWWWWWWWWWWWWWWWWWWWWWWWWWWWWWWWWWWWWWWWWWWWWWWWWWWWWWWWWWWWWWW
W             W W             W W             W W             W W      W      W W             W W             W W             WWWWWWWWW
W  A      g   W W  A          W W          A  W W   g      A  W W  A   W      W W  A          W W          A  W W         A   WWWWWWWWW
W             W W             W W             W W             W W      W      W W             W W             W W             WWWWWWWWW
W   m    a    W W         g   W W   g         W W             W W      W  g   W W         g   W W   g         W W             WWWWWWWWW
WWWWWWWWWWWWWWW W             W W      W      W W      W      W W             W W      W      W W      W      W W      W      WWWWWWWWW
W A      g     W W  m   W      W W      W   m  W W      W   m  W W  m          W W  m   W      W W      W   m  W W      W   m WWWWWWWWW
W              W WWWWWWWW      W W      WWWWWWWW W      WWWWWWWW W WWWWWW      WWWWWWWWWW    W W         WWWWWWW     WWWWWWWWWWWWWWWWWW
W   m      a   W              W W             W W      W      W W             W W              W W             W W      W     WWWWWWWWW
W              WW W             W W             W W      W      W W             W W             W W             W W      W    WWWWWWWWW
WWWWWWWWWWWWWW W             W W             W W         a   W W             W W             W W             W W      W  a    WWWWWWWWW
W  m   a   g  W W  a   W      W W      W  a   W W             W W  a          W W  a   W      W W       W  a  W W             WWWWWWWWW
W             W W      W      W W      W      W W             W W      W      W W      W      W W       W     W W    g        WWWWWWWWW
W A           W W      WWWWWWWW WWWWWWWW      W WWWWW         W W      WWWWWWWW W      WWWWWWWW W       W WWWWW               WWWWWWWWW
WWWWWWWWWWWWWWWWWWWWWWWWWWWWWWWWWWWWWWWWWWWWWWWWWWWWWWWWWWWWWWWWWWWWWWWWWWWWWWWWWWWWWWWWWWWWWWWWWWWWWWWWWWWWWWWWWWWWWWWWWWWWWWWWWWWWWWW
W A            W  A             W m         W m W                 W                        a  Wa                             gWWWWWWWWW
W            g W               WW               W   A             W W      A          WWWWWWW W                               WWWWWWWWW
W              W              g W               W                 W W                         W                               WWWWWWWWW
W              W W              W  A            W                 W W                         W                               WWWWWWWWW
W m            W m              WWWW            W                 W W   W                     W               A               WWWWWWWWW
W              W               WW g             W        W        W W   W                     W                               WWWWWWWWW
W           a  W               aW             a W    g   W    a   W W   W          WWWWWWWWWWWW                               WWWWWWWWW
W              W                W            W  W        W        W W m W                  g  W                              mWWWWWWWWW
WWWWWWWWWWWWWWWWWWWWWWWWWWWWWWWWWWWWWWWWWWWWWWWWWWWWWWWWWWWWWWWWWWWWWWWWWWWWWWWWWWWWWWWWWWWWWWWWWWWWWWWWWWWWWWWWWWWWWWWWWWWWWWWWWWWWWWW
WWWWWWWWWWWWWWWWWWWWWWWWWWWWWWWWWWWWWWWWWWWWWWWWWWWWWWWWWWWWWWWWWWWWWWWWWWWWWWWWWWWWWWWWWWWWWWWWWWWWWWWWWWWWWWWWWWWWWWWWWWWWWWWWWWWWWWW
W A       W  A             W m         W m W                 W                        a  Wa                             gWWWWWWWWWWWWWW
W       g W              WWW               W   A             W W      A          WWWWWWW W                               WWWWWWWWWWWWWW
W         W              g W               W                 W W                         W                               WWWWWWWWWWWWWW
W         W W              W  A            W                 W W                         W                               WWWWWWWWWWWWWW
W m       W m              WWWW            W                 W W   W                     W               A               WWWWWWWWWWWWWW
W         W                WW g             W        W        W W   W                     W                              WWWWWWWWWWWWWW
W      a  W               aW             a W    g   W    a   W W   W          WWWWWWWWWWWW                               WWWWWWWWWWWWWW
W         W                W            W  W        W        W W m W                  g  W                              mWWWWWWWWWWWWWW
WWWWWWWWWWWWWWWWWWWWWWWWWWWWWWWWWWWWWWWWWWWWWWWWWWWWWWWWWWWWWWWWWWWWWWWWWWWWWWWWWWWWWWWWWWWWWWWWWWWWWWWWWWWWWWWWWWWWWWWWWWWWWWWWWWWWWWW 