####################################################
#                                                  #
#         ##########                               #
#         # a a a  #                               #
#         #        #                               #
#                                                  #
#                                                  #
#                                ##########        #
#                                #  c c c #        #
#                                #        #        #
#         #############                            #
#         #  g  g g   #                            #
#         #           #                            #
#                                                  #
#                                                  #
#      A        A         A         A         A    #
#                                                  #
####################################################
####################################################
#         #############                            #
#         #  a  a  a  #                            #
#         #           #                            #
#                                ##########        #
#                                #  c c c #        #
#                                         #        #
#         #############                            #
#         #  g  g  g  #                            #
#         #                                        #
#                                                  #
#                                                  #
#                   A A  A  A  A                   #
####################################################