WWWWWWWWWWWWWWWWWWWWWWWWWWWWWWWWWWWWWWWWWWWWWWWWWW
W                       WW                       W
W     A      a          WW             A     a   W
W                       WW                       W
W      g     c          WW                       W
W                       WW                   c   W
W                       WW                       W
W                       WW           g           W
WWWWWWWWWWWWWWWWWWWWWWWWWWWWWWWWWWWWWWWWWWWWWWWWWW
WWWWWWWWWWWWWWWWWWWWWWWWWWWWWWWWWWWWWWWWWWWWWWWWWW
W                       WW                       W
W      A       g        WW     A                 W
W                       WW                       W
W               c       WW           c           W
W                       WW     g         a       W
W           a           WW                       W
W                       WW                       W
WWWWWWWWWWWWWWWWWWWWWWWWWWWWWWWWWWWWWWWWWWWWWWWWWW