##################################################
#                       ##                       #
#             A     a   ##             A     a   #
#                       ##                       #
#                       ##                       #
#                   c   ##                   c   #
#                       ##                       #
#           g           ##           g           #
##################################################
##################################################
#                       ##                       #
#             A     a   ##             A     a   #
#                       ##                       #
#                       ##                       #
#                   c   ##                   c   #
#                       ##                       #
#           g           ##           g           #
##################################################