##################################################
#                       ##                       #
#     A      a          ##             A     a   #
#                       ##                       #
#      g     c          ##                       #
#                       ##                   c   #
#                       ##                       #
#                       ##           g           #
##################################################
##################################################
#                       ##                       #
#      A       g        ##     A                #
#                       ##                       #
#               c       ##           c           #
#                       ##     g         a       #
#           a           ##                       #
#                       ##                       #
##################################################