WWWWWWWWWWW
W g  W   cW
W    W    W
W    W    W
W    W    W
W    a    W
W         W
W         W
W         W
W         W
W         W
W         W
W         W
W    A    W
WWWWWWWWWWW