########################
#......................#
#......................#
#......................#
#.........@............#
#..........x...........#
#......................#
#......................#
#......................#
########################

