################
#._#.@#._#..#..#
#..#..#..#..#..#
#..#..#..#..#..#
#..#..#..#..#..#
#..#..#..#..#..#
#..#..#..#..#..#
#..#..#..#..#..#
#..#..#..#..#..#
#..#..#..#..#..#
#..#..#..#..#..#
#..#..#..#..#..#
#..#.##..#..#..#
#..............#
#..............#
#..............#
#..._..........#
#..............#
#..............#
################
