########################################################################
#....................................................................@.#
#......................................................................#
#.....##################################################################
#.....#_........................................................._.....#
#.....#................................................................#
#.....#................................................................#
#.....#................................................................#
#.....#................................................................#
#.....#................................................................#
#.....#................................................................#
#.....#................................................................#
#.....##########################################################.......#
#......................................................................#
#......................................................................#
#......................................_...............................#
########################################################################
