type: mettagrid.map_builder.ascii.AsciiMapBuilder.Config
map_data: |-
  ################################
  #............m.................#
  #..............................#
  #...########################...#
  #...#......................#...#
  #...#...######.#########...#...#
  #...#...#..............#...#..n#
  #...#...#..#########...#...#...#
  #...#...#..#..@....#...#...#...#
  #...#...#..#.......#...#...#...#
  #...#...#..#.......#...#.......#
  #...#...#..#...........#...#...#
  #...#...#..#########...#...#.._#
  #...#...#..............#...#...#
  #...#...################...#...#
  #...#......................#...#
  #...########################...#
  #..............................#
  ################################
char_to_map_name:
  "#": wall
  ".": empty
  "m": mine_red
  "n": generator_red
  "@": agent.agent
  "_": assembler
