type: mettagrid.map_builder.ascii.AsciiMapBuilder.Config
map_data: |-
  ##################################
  #...........#....................#
  #...#...#...#....................#
  #...#...#...#....................#
  #...#...#...#....................#
  #...#...#...#....................#
  #####...#...#....................#
  #...#...#...#....................#
  #...#...#...#....................#
  #...#...#...#....................#
  #.n.#...#.n.#....................#
  #####...##########################
  #................................#
  #......................@.........#
  #................................#
  #................................#
  #####...##############...#########
  #._.#...#._.#.....#.m.#...#.m.#..#
  #...#...#...#.....#...#...#...#..#
  #...#...#...#.....#...#...#...#..#
  #...#...#...#.....#...#...#...#..#
  #####...#...#.....#####...#...#..#
  #...#...#...#.....#...#...#...#..#
  #...#...#...#.....#...#...#...#..#
  #...#...#...#.....#...#...#..##..#
  #...#...#...#.....#...#...#...#..#
  #...#...#...#.....#...#...#...#..#
  #...#...#...#.....#...#...#...#..#
  #...........#.....#...........#..#
  ##################################
char_to_map_name:
  "#": wall
  ".": empty
  "n": generator_red
  "@": agent.agent
  "_": altar
  "m": mine_red
