type: mettagrid.map_builder.ascii.AsciiMapBuilder.Config
map_data: |-
  ##########################################################################
  ##########################################################################
  #######################......########################......###.._..#######
  #######################......########################......###.....#######
  #######################......########################......###.....#######
  ####.....##############......#####..n..##############......###.....#######
  ####.....##############......#####.....##############......###.....#######
  ####.....##############......#####.....##############......###.....#######
  ####.....#####....#####......#####.....#####....#####......###.....#######
  ####.....#####....####.......#####.....#####....####.......###.....#######
  #..................................................................#######
  #..................................................................#######
  #@.................................................................#######
  #..................................................................#######
  #..................................................................#######
  ###...m..####.....###############......####.....############.......#######
  ###......####.....###############......####.....############.......#######
  #############.....#########################.....############.......#######
  #############.....#########################.....############.......#######
  #############.....#########################.....##########################
  #############.....#########################.....##########################
  #############.....#########################.....##########################
  #############.....#########################.....##########################
  ##########################################################################
  ##########################################################################
  ##########################################################################
char_to_map_name:
  "#": wall
  ".": empty
  "_": assembler
  "n": generator_red
  "@": agent.agent
  "m": mine_red
