map_data: |-
  ################################
  #..............................#
  #..............................#
  #..............................#
  #..............................#
  #..............................#
  #.....####################.....#
  #..............n...............#
  #.....####################.....#
  #..............................#
  #.....@........................#
  #...............#######........#
  #..................m...........#
  #...............#######........#
  #..............................#
  #..............................#
  #..............................#
  #..............................#
  #...........#..#...............#
  #...........#..#...............#
  #...........#..#...............#
  #...........#..#...............#
  #...........#..#...............#
  #...........#._#...............#
  #...........#..#...............#
  #...........#..#...............#
  #...........#..#...............#
  #...........#..#...............#
  #...........#..#...............#
  #..............................#
  #..............................#
  #..............................#
  #..............................#
  #..............................#
  #..............................#
  ################################
char_to_name_map:
  "#": wall
  ".": empty
  "n": generator_red
  "@": agent.agent
  "m": mine_red
  "_": altar
