type: mettagrid.map_builder.ascii.AsciiMapBuilder.Config
map_data: |-
  ########################################
  #......................................#
  #..............................m.......#
  #......................................#
  #......................................#
  #......................................#
  #......................................#
  #......................................#
  #......................................#
  #......................................#
  #......................................#
  #......................................#
  #......................................#
  #......................................#
  #......................................#
  #......................................#
  #......................................#
  #......................................#
  #......................................#
  #......................................#
  #......................................#
  #..................@...................#
  #......................................#
  #......................................#
  #......................................#
  #......................................#
  #......................................#
  #......................................#
  #......................................#
  #......................................#
  #n.....................................#
  #......................................#
  #......................................#
  #......................................#
  #......................................#
  #......................................#
  #......................................#
  #......................................#
  #......................................#
  #......................................#
  #......................................#
  #......................................#
  #......................................#
  #......................................#
  #......................................#
  #..............................._......#
  ########################################
char_to_name_map:
  "#": wall
  ".": empty
  "m": mine_red
  "@": agent.agent
  "n": generator_red
  "_": altar
