type: mettagrid.map_builder.ascii.AsciiMapBuilder
map_data: |-
  #################################
  #..........#....................#
  #...#...#..#....................#
  #...#...#..#....................#
  #...#...#..#....................#
  #...#...#..#....................#
  #..##...#..#....................#
  #...#...#..#....................#
  #...#...#..#....................#
  #...#...#..#....................#
  #.n.#...#..#....................#
  #####...#########################
  #...............................#
  #......................@........#
  #...............................#
  #...............................#
  #####...##############...########
  #._.#...#..#.....#...#...#.m.#..#
  #...#...#..#.....#...#...#...#..#
  #...#...#..#.....#...#...#...#..#
  #...#...#..#.....#...#...#...#..#
  #...#...#..#.....#...#...#...#..#
  #..##...#..#.....#...#...#...#..#
  #...#...#..#.....#...#...#...#..#
  #...#...#..#.....#...#...#..##..#
  #...#...#..#.....#...#...#...#..#
  #...#...#..#.....#...#...#...#..#
  #...#...#..#.....#...#...#...#..#
  #..........#.....#...........#..#
  #################################
char_to_name_map:
  "#": wall
  ".": empty
  "n": generator_red
  "@": agent.agent
  "_": altar
  "m": mine_red
