type: mettagrid.map_builder.ascii.AsciiMapBuilder.Config
map_data: |-
  ######################
  n...#####...###....m.#
  ##.....###..##....####
  ####....##..#....#####
  #####..........#######
  #........@...........#
  #######........#######
  #####....#..#.....####
  ###.....##..####....##
  #....#####..######._##
  ######################
char_to_name_map:
  "#": wall
  "n": generator_red
  ".": empty
  "m": mine_red
  "@": agent.agent
  "_": altar
