########################################
#......................................#
#......................................#
#....##########........................#
#....#........#........................#
#....#........#........................#
#....#........#........................#
#....#.......@#........................#
#....#........#........................#
#....#........#........................#
#....#.................................#
#....#........#........................#
#....##########........................#
#......................................#
#......................................#
#.......................##############.#
#.......................#............#.#
#.......................#............#.#
#....................................#.#
#.......................#............#.#
#.......................#............#.#
#.......................#............#.#
#.......................#............#.#
#.......................#............#.#
#.......................#............#.#
#.......................#............#.#
#.......................#............#.#
#.......................#...m........#.#
#.......................##############.#
#......................................#
#......................................#
#..####################................#
#..#..................#................#
#..#..................#................#
#..#..................#................#
#..#..................#................#
#..#..................#................#
#..#..................#................#
#..#..................#................#
#..#..................#................#
#..#..................#................#
#..#..........n........................#
#..#..................#................#
#..####################................#
#........_.............................#
#......................................#
########################################
