type: mettagrid.map_builder.ascii.AsciiMapBuilder.Config
map_data: |-
  ########################################################################
  #....................................................................@.#
  #......................................................................#
  #.....##################################################################
  #.....#................................................................#
  #.....#................................................................#
  #.....#................................................................#
  #.....#................................................................#
  #.....#................................................................#
  #.....#................................................................#
  #.....#................................................................#
  #.....#................................................................#
  #.....#................................................................#
  #.....#................................................................#
  #.....#................................................................#
  #.....#................................................................#
  #.....#................................................................#
  #.....#................................................................#
  #.....#................................................................#
  #.....#................................................................#
  #.....#................................................................#
  #.....#................................................................#
  #.....#................................................................#
  #.....#................................................................#
  #.....#................................................................#
  #.....#................................................................#
  #.....#................................................................#
  #.....#.m..............................................................#
  #.....#................................................................#
  #.....#................................................................#
  #.....#................................................................#
  #.....#................................................................#
  #.....#................................................................#
  #.....#................................................................#
  #.....#................................................................#
  #.....#................................................................#
  #.....#................................................................#
  #.....#................................................................#
  #.....#................................................................#
  #.....##########################################################....._.#
  #......................................................................#
  #......................................................................#
  #........................................n.............................#
  ########################################################################
char_to_map_name:
  "#": wall
  ".": empty
  "@": agent.agent
  "m": mine_red
  "_": altar
  "n": generator_red
