type: mettagrid.map_builder.ascii.AsciiMapBuilder
map_data: |-
  #####################
  #.._................#
  #...................#
  #...................#
  #...................#
  #......#............#
  #...................#
  #..............#....#
  #...................#
  #..........@........#
  #..................n#
  #...................#
  #...................#
  #.............##....#
  #...................#
  #....#..............#
  #...................#
  #...................#
  #.....m.............#
  #...................#
  #####################
char_to_name_map:
  "#": wall
  ".": empty
  "_": altar
  "@": agent.agent
  "n": generator_red
  "m": mine_red
