type: mettagrid.map_builder.ascii.AsciiMapBuilder
map_data: |-
  ##################
  #.......@........#
  #................#
  #................#
  ######.....#######
  #.._.#.....#..n..#
  #....#.....#.....#
  #....#.....#.....#
  #....#.....#.....#
  #.n..#.....#.....#
  #....#.....#._...#
  #....#.....#.....#
  #..m.#.....#.m...#
  #....#.....#.....#
  #....#.....#######
  #....#.....#.....#
  #....#.....#.....#
  #....#.....#.....#
  #....#.....#.....#
  #....#.....#.....#
  #....#.....#.....#
  #....#.....#.....#
  #....#.....#.....#
  #....#.....#.....#
  #....#.....#.....#
  #....#.....#.....#
  #....#.....#.....#
  #....#.....#.....#
  #....#.....#.....#
  #....#.....#.....#
  #....#.....#.....#
  #................#
  #................#
  #................#
  ##################
char_to_name_map:
  "#": wall
  ".": empty
  "@": agent.agent
  "_": altar
  "n": generator_red
  "m": mine_red
