#########################################
#.................TTT...................#
#.......................................#
#.......................................#
#_.................@....................#
#.......................................#
#.................TTT...................#
#########################################
