########################################
#........#...m....#........#...........#
#...B.G..#.G...B..#.B.m.G..#...B.m.G...#
#......................................#
#......................................#
#...m..................................#
#........#........#........#...........#
#........#........#........#...........#
##################################.....#
#........#........#........#...........#
#........#........#..m.....#...........#
#......................................#
#..B...................................#
#......................................#
#..G...m.#..m.G.B.#...B.G..#.m.B.G.....#
#........#........#........#...........#
########################################
