###########
#.....#...#
#.....#...#
#.###.###.#
#...#.#...#
###.#.#.###
#...#.#...#
#...#_#...#
#.#######.#
#....@....#
###########
