#######################
#.....................#
#.....................#
#..################...#
#..#..............#...#
#..#...########...#...#
#..#...#...S..#...#...#
#..#...#.@....#...#...#
#..#...#......#...#...#
#..#...#......#...#...#
#..#...########...#...#
#..#..............#...#
#..################...#
#.....................#
#........._...........#
#.....................#
#######################
