########################
#.#.#.#_#.#.#.#.#_#.#.##
#.#.#.#.#.#.#.#.#.#.#.##
#.#.#.#.#.#.#.#.#.#.#.##
#.#.#.#.#.#.#.#.#.#.#.##
#.#.#.#.#.#.#.#.#.#.#.##
#.#.#.#.#.#.#.#.#.#.#.##
#.#.#.S.S.#.#.#.S.S.#.##
#.....................##
#.#.#.#.#.S.S.#.#.#.#.##
#.#.#.#.#.#.#.#.#.#.#.##
#.#.#.#.#.#.#.#.#.#.#.##
#.#.#.#.#.#.#.#.#.#.#.##
#.#.#.#.#.#.#.#.#.#.#.##
#.#.#.#.#.#.#.#.#.#.#.##
#@#.#.#.#.#_#.#.#.#.#.##
########################
