#######################
#.....................#
#...ssssssssssssss....#
#...s............s....#
#...s..ssssssss..s....#
#...s..s......s..s....#
#...s..s.@....s..s....#
#...s..s......s..s....#
#...s..s......s..s....#
#...s..ssssssss..s....#
#...s............s....#
#...ssssssssssssss....#
#........._...........#
#.....................#
#######################
