##############T##########
##.....................##
#.#########...T#####..#.#
#..#......#...#......##.#
#...#.....#...#.....#.#.#
#.#..#....#...#....#..#.#
#.#...#...#...#...#...#.#
#.#....#..#...#..#....#.#
#.#.....#.#...#.#.....#.#
#.#......_#...#_......#.#
T.T########...#########.#
#.......................#
#...........@...........#
#.......................#
#.#########...########T.T
#.#......_#...#_......#.#
#.#.....#.#...#.#.....#.#
#.#....#..#...#..#....#.#
#.#...#...#...#...#...#.#
#.#..#....#...#....#..#.#
#.#.#.....#...#.....#...#
#.##......#...#......#..#
#.#..#####T...#########.#
##.....................##
##########T##############
