################################
#............_.................#
#..............................#
#...########################...#
#...#......................#...#
#...#...######.#########...#...#
#...#...#..............#...#.._#
#...#...#..#########...#...#...#
#...#...#..#..@....#...#...#...#
#...#...#..#.......#...#...#...#
#...#.._#..#.......#...#.......#
#...#...#..#...........#...#...#
#...#...#..#########...#...#...#
#...#...#..............#...#...#
#...#...################...#...#
#...#......................#...#
#...########################...#
#..............................#
################################
