################################
#............_.................#
#..............................#
#...########################...#
#...#......................#...#
#...#......................#...#
#...#......#########.......#.._#
#...#......#...............#...#
#...#......#...............#...#
#...#......#.@........######...#
#...#......#############.......#
#...#......#...............#...#
#...#......#...............#.._#
#...#......###########.....#...#
#...#......................#...#
#...#......................#...#
#...########################...#
#..............................#
################################