########################################
#......................................#
#......................................#
#......................................#
#......#######.........................#
#........._............................#
#......#######.........................#
#......................................#
#......................................#
#..............@.............#.#.......#
#............................#.#.......#
#............................#_#.......#
#............................#.#.......#
#............................#.#.......#
#......................................#
#......................................#
#.............#.#......................#
#.............#_#......................#
#.............#.#......................#
#......................................#
########################################