#############################
#.._.#...#...#....#.@..#.._.#
#....#...#...#....#....#....#
#....#...#...#....#....#....#
#....#...#...#....#....#....#
#....#...#...#....#....#....#
#....#...#...#....#....#....#
#....#...#...#....#....#....#
#....#...#...#....#....#....#
#....#...#...#....#...##....#
#...........................#
#...........................#
#...........................#
#...........................#
#...........................#
#...........................#
#...........................#
#...........................#
#...........................#
#...........................#
#...........................#
#......._...................#
#...........................#
#...........................#
#...........................#
#...........................#
#############################
