#######################################################################
#......#......#......#......#......#......#......#......#......#......#
#......#......#.............#......#......#......#......#......#......#
#..@........................#......#......#......#......#......#......#
#....................#......#......#......#......#......#......#......#
#......#......#......#......#......#......#......#......#......#......#
###..###################...############################################
#......#.............#......#.............#......#......#.............#
#......#.............#......#.............#......#....................#
#.............#......#.............#.._...#...........................#
#.............#....................#......#.............#.............#
#......#......#......#......#......#.............#......#.............#
#####..###.#####..#######..####.########.####.########.###.........._.#
#......#......#......#......#......#.............#......#.............#
#.............#.............#......#.............#....................#
#.............#......#.._.................#......#....................#
#......#.............#......#.............#.............#.............#
#......#.............#......#......#......#.............#.............#
#######################################################################