###########
#.._......#
#......#..#
#.........#
#....@....#
#........_#
#...##....#
#....#....#
#....._...#
###########
