###########
#........_#
#........_#
#........_#
#........_#
#........_#
#1.1.1.1._#
#........_#
#........_#
#........_#
#........_#
#........_#
###########
