#############
#.....1.....#
#...........#
#.....1.....#
#...........#
#.....1.....#
#...........#
#.....1.....#
#...........#
#___________#
#############
