####################################################
#........................1........................_#
####################################################
#........................1......................._.#
####################################################
#........................1......................_..#
####################################################
#........................1....................._...#
####################################################
#........................1...................._....#
####################################################
#........................1..................._.....#
####################################################
#........................1.................._......#
####################################################
#........................1................._.......#
####################################################
#........................1................_........#
####################################################
#........................1..............._.........#
####################################################
#........................1.............._..........#
####################################################
#........................1............._...........#
####################################################
#........................1............_............#
####################################################
#........................1..........._.............#
####################################################
#........................1.........._..............#
####################################################
#........................1........._...............#
####################################################
#........................1........_................#
####################################################
#........................1......._.................#
####################################################
#........................1......_..................#
####################################################
#........................1....._...................#
####################################################
#........................1...._....................#
####################################################
#........................1..._.....................#
####################################################
#........................1.._......................#
####################################################
#########################2##########################
