################################################
##.#.#.#.#.#.#.#.#.#.#.#.#.#.#.#.#.#.#.#.#.#.#_#
##.#.#.#.#.#.#.#.#.#.#.#.#.#.#.#.#.#.#.#.#.#_#.#
##.#.#.#.#.#.#.#.#.#.#.#.#.#.#.#.#.#.#.#.#_#.#.#
##.#.#.#.#.#.#.#.#.#.#.#.#.#.#.#.#.#.#.#_#.#.#.#
##.#.#.#.#.#.#.#.#.#.#.#.#.#.#.#.#.#.#_#.#.#.#.#
##.#.#.#.#.#.#.#.#.#.#.#.#.#.#.#.#.#_#.#.#.#.#.#
##.#.#.#.#.#.#.#.#.#.#.#.#.#.#.#.#_#.#.#.#.#.#.#
##.#.#.#.#.#.#.#.#.#.#.#.#.#.#.#_#.#.#.#.#.#.#.#
##.#.#.#.#.#.#.#.#.#.#.#.#.#.#_#.#.#.#.#.#.#.#.#
##.#.#.#.#.#.#.#.#.#.#.#.#.#_#.#.#.#.#.#.#.#.#.#
##.#.#.#.#.#.#.#.#.#.#.#.#_#.#.#.#.#.#.#.#.#.#.#
##.#.#.#.#.#.#.#.#.#.#.#_#.#.#.#.#.#.#.#.#.#.#.#
##.#.#.#.#.#.#.#.#.#.#_#.#.#.#.#.#.#.#.#.#.#.#.#
##.#.#.#.#.#.#.#.#.#_#.#.#.#.#.#.#.#.#.#.#.#.#.#
##.#.#.#.#.#.#.#.#_#.#.#.#.#.#.#.#.#.#.#.#.#.#.#
##.#.#.#.#.#.#.#_#.#.#.#.#.#.#.#.#.#.#.#.#.#.#.#
##.#.#.#.#.#.#_#.#.#.#.#.#.#.#.#.#.#.#.#.#.#.#.#
##.#.#.#.#.#_#.#.#.#.#.#.#.#.#.#.#.#.#.#.#.#.#.#
##.#.#.#.#_#.#.#.#.#.#.#.#.#.#.#.#.#.#.#.#.#.#.#
##.#.#.#_#.#.#.#.#.#.#.#.#.#.#.#.#.#.#.#.#.#.#.#
##.#.#_#.#.#.#.#.#.#.#.#.#.#.#.#.#.#.#.#.#.#.#.#
##.#_#.#.#.#.#.#.#.#.#.#.#.#.#.#.#.#.#.#.#.#.#.#
##_#.#.#.#.#.#.#.#.#.#.#.#.#.#.#.#.#.#.#.#.#.#.#
##.#.#.#.#.#.#.#.#.#.#.#.#.#.#.#.#.#.#.#.#.#.#.#
##.#.#.#.#.#.#.#.#.#.#.#.#.#.#.#.#.#.#.#.#.#.#.#
2#1#1#1#1#1#1#1#1#1#1#1#1#1#1#1#1#1#1#1#1#1#1#1#
##.#.#.#.#.#.#.#.#.#.#.#.#.#.#.#.#.#.#.#.#.#.#.#
##.#.#.#.#.#.#.#.#.#.#.#.#.#.#.#.#.#.#.#.#.#.#.#
##.#.#.#.#.#.#.#.#.#.#.#.#.#.#.#.#.#.#.#.#.#.#.#
##.#.#.#.#.#.#.#.#.#.#.#.#.#.#.#.#.#.#.#.#.#.#.#
##.#.#.#.#.#.#.#.#.#.#.#.#.#.#.#.#.#.#.#.#.#.#.#
##.#.#.#.#.#.#.#.#.#.#.#.#.#.#.#.#.#.#.#.#.#.#.#
##.#.#.#.#.#.#.#.#.#.#.#.#.#.#.#.#.#.#.#.#.#.#.#
##.#.#.#.#.#.#.#.#.#.#.#.#.#.#.#.#.#.#.#.#.#.#.#
##.#.#.#.#.#.#.#.#.#.#.#.#.#.#.#.#.#.#.#.#.#.#.#
##.#.#.#.#.#.#.#.#.#.#.#.#.#.#.#.#.#.#.#.#.#.#.#
##.#.#.#.#.#.#.#.#.#.#.#.#.#.#.#.#.#.#.#.#.#.#.#
##.#.#.#.#.#.#.#.#.#.#.#.#.#.#.#.#.#.#.#.#.#.#.#
##.#.#.#.#.#.#.#.#.#.#.#.#.#.#.#.#.#.#.#.#.#.#.#
##.#.#.#.#.#.#.#.#.#.#.#.#.#.#.#.#.#.#.#.#.#.#.#
##.#.#.#.#.#.#.#.#.#.#.#.#.#.#.#.#.#.#.#.#.#.#.#
##.#.#.#.#.#.#.#.#.#.#.#.#.#.#.#.#.#.#.#.#.#.#.#
##.#.#.#.#.#.#.#.#.#.#.#.#.#.#.#.#.#.#.#.#.#.#.#
##.#.#.#.#.#.#.#.#.#.#.#.#.#.#.#.#.#.#.#.#.#.#.#
##.#.#.#.#.#.#.#.#.#.#.#.#.#.#.#.#.#.#.#.#.#.#.#
##.#.#.#.#.#.#.#.#.#.#.#.#.#.#.#.#.#.#.#.#.#.#.#
##.#.#.#.#.#.#.#.#.#.#.#.#.#.#.#.#.#.#.#.#.#.#.#
##.#.#.#.#.#.#.#.#.#.#.#.#.#.#.#.#.#.#.#.#.#.#.#
##.#.#.#.#.#.#.#.#.#.#.#.#.#.#.#.#.#.#.#.#.#.#.#
##.#.#.#.#.#.#.#.#.#.#.#.#.#.#.#.#.#.#.#.#.#.#.#
################################################
