#############
#############
#############
#############
#...........#
#...........#
#...........#
#...#...#...#
#...#...#...#
#...#...#...#
#...#...#...#
#...#...#...#
#...#...#...#
#...#...#...#
#...#...#...#
#...#...#...#
#...#...#...#
#...#...#...#
#...#...#...#
#...#...#...#
#...#...#...#
#...#...#...#
#...#...#...#
#...#...#...#
#...#...#...#
#...#...#...#
#...#...#...#
#...#...#...#
#...#...#...#
#...#...#...#
#...#...#...#
#...#...#...#
#...#...#...#
#...#...#...#
#...#...#...#
#...#...#...#
#...#...#...#
#...#...#...#
#...#...#...#
#...#...#...#
#...#...#...#
#...#...#...#
#...#...#...#
#...#...#...#
#...#...#...#
#...#...#...#
#...#...#...#
#...#.@.#___#
#############
#############
#############
#############
#############
#...........#
#...........#
#...........#
#...#...#...#
#...#...#...#
#...#...#...#
#...#...#...#
#...#...#...#
#...#...#...#
#...#...#...#
#...#...#...#
#...#...#...#
#...#...#...#
#...#...#...#
#...#...#...#
#...#...#...#
#...#...#...#
#...#...#...#
#...#...#...#
#...#...#...#
#...#...#...#
#...#...#...#
#...#...#...#
#...#...#...#
#...#...#...#
#...#...#...#
#...#...#...#
#...#...#...#
#...#...#...#
#...#...#...#
#...#...#...#
#...#...#...#
#...#...#...#
#...#...#...#
#...#...#...#
#...#...#...#
#...#...#...#
#...#...#...#
#...#...#...#
#...#...#...#
#...#...#...#
#...#...#...#
#...#...#...#
#___#.@.#...#
#############
#############
#############
#############
#############
#############
