########################################################################
#              #a               #               #a            #        #
#              #                #               #             #        #
#              #                #               #             #        #
#              #                #               #             #        #
#              #              t #               #           t #        #
############## ################ ############### ############# ######## #
#                                                                      #
#                                                                      #
#                                                                      #
#                                                                      #
#                                                                      #
############## ################ ############### ############# ######## #
#            t #                #             t #             #      t #
#              #                #               #             #        #
#              #                #               #             #        #
#              #                #               #             #        #
#              #                #               #             #        #
#a             #                #a              #             #a       #
########################################################################
