WWWWWWWWWWWWWWWWWWWWWWWWWWWWWWWWWWWWWWWWWWWWWWWWWWWWWWWWWWWWWWWWWWWWWWWWWWWWWWWWWWWWWWWWWWWWWWWWWW
W           WWWWWWWWWWWWWWWWWWWWWWWWWWWWWWWWWWWWWWWWWWWWWWW           WWWWWWWWWWWWWWWWWWWWWWWWWWWWWWWWW
W           WWa                    WWWWW                   aWW           WWWW                   aWWWWW
W           WWa                    WWWWW                   aWW           WWWW                   aWWWWW
W   W   W   WWa                    WWWWW                   aWW   W   W   WWWW                   aWWWWW
W   W   W   WWWWWWWWWWWWWWWWWWWW   WWWWWWWWWWWW   WWWWWWWWWWWW   W   W   WWWW   WWWWWWWWWWWWWWWWWWWWWWW
W   W   W   WW                     WWWWW                   WW   W   W   WWWW                          W
W   W A W   WW                     WWWWWA                  WW   W A W   WWWW                         AW
W   W   W   WW                     WWWWW                   WW   W   W   WWWW                          W
W   W   W   WWWWWWWWWWWWWWWWWWWW   WWWWWWWWWWWW   WWWWWWWWWWWW   W   W   WWWW   WWWWWWWWWWWWWWWWWWWWWWW
W   W   W   WW                     WWWWWa                  WW   W   W   WWWW                   aWWWWW
W   W   W   WW                     WWWWWa                  WW   W   W   WWWW                   aWWWWW
W   W   W   WW                     WWWWWa                  WW   W   W   WWWW                   aWWWWW
W   W   W   WWWWWWWWWWWWWWWWWWWWWWWWWWWWWWWWWWWWWWWWWWWWWWWWW   W   W   WWWWWWWWWWWWWWWWWWWWWWWWWWWWWW
W   W   W                                                      W   W                                  W
W   W   W                                                      W   W                                  W
W   W   W                                                      W   W                                  W
W           WWWWWWWWWWWWWWWWWWWWWWWWWWWWWWWWWWWWWWWWWWWWWWWWWWW                                       W
W           WWa                    WWWWW                   aWW                                       W
W           WWa                    WWWWW                   aWW                                       W
W   W   W   WWa                    WWWWW                   aWW                                       W
W   W   W   WWWWWWWWWWWWWWWWWWWW   WWWWWWWWWWWW   WWWWWWWWWWWW                                       W
W   W   W   WW                     WWWWW                   WW                                       W
W   W A W   WW                     WWWWWA                  WW                                       W
W   W   W   WW                     WWWWW                   WW                                       W
W   W   W   WWWWWWWWWWWWWWWWWWWW   WWWWWWWWWWWW   WWWWWWWWWWWW                                       W
W   W   W   WW                     WWWWWa                  WW                                       W
W   W   W   WW                     WWWWWa                  WW                                       W
W   W   W   WW                     WWWWWa                  WW                                       W
W   W   W   WWWWWWWWWWWWWWWWWWWWWWWWWWWWWWWWWWWWWWWWWWWWWWWWW                                       W
W   W   W                                                                                           W
W   W   W                                                                                           W
W   W   W                                                                                           W
W                                                                                                   W
W                                                                                                   W
W                                                                                                   W
WWWWWWWWWWWWWWWWWWWWWWWWWWWWWWWWWWWWWWWWWWWWWWWWWWWWWWWWWWWWWWWWWWWWWWWWWWWWWWWWWWWWWWWWWWWWWWWWWW