WWWWWWWWWWWWWWWWWWWWWWWWWWWWWWWWWWWWWWWWWWWWWWWWWWWWWWWWWWWWWWWWWWWWWWWWWWWWWWWWWWWWWWWWWWWWWWWWWWWWWWWWWWWWWWWWWWWWWWWWWW
WWWWWWWWWWWWW  WWWWWWWWWWWWWWWWWWWWWWWWWWWWWWWWWWWWWWWWWWWWW  WWWWWWWWWWWWW  WWWWWWWWWWWWWWWWWWWWWWWWWWWWWWWWWWWWWWWWWWWWW
WWWWWWWWWWWWW  WWa     W     WWWWW     W     a  WWWV  WWWWWWWWWWWWW  WWVV     a  W     WWWWV     W     aWWW
WWWWWWWWWWWWW  WWa     W     WWWWW     W       WWWW  W   W A WaaaW  WWWW       W     WWVVV     W     aWWW
WWWWWWWWWWWWW  WWa           WWVVV           a  WWWW  W   W   W   W  WWVV  a           WWVVV           aWWW
WW           W  WWWWWWWWWWWWWWWWWW   WWWWWWWWWWWWWW   WWWW  W   W   W   W  WWWW   WWWWWWWWWWWWWWWWWWW   WWWWWWWWWWWWWWWW
WW           W  WW                   WWVVV                 WWWW  W   W   W   W  WWWW                 WWVVV                 WWW
WW           W  WWA                  WWVVVA                WWWW  W   W   W   W  WWVV                AWWVVV                AWWW
WW   W   W   W  WW                   WWVVV                 WWWW  W   W   W   W  WWVV                 WWVVV                 WWW
WW   W   W   W  WWWWWWWWWWWWWWWWW   WWWWWWWWWWWWWWWWWWW   WWVV  W   W   W   W  WWWV   WWWWWWWWWWWWWWWWWWW   WWWWWWWWWWWWWWVW
WW   W   W   W  WW                   WWVVVa                WWVV  W   W   W   W  WWWV                 WWVVV                aWWW
WW   W   W   W  WW                   WWVVVa                WWVV  W   W   W   W  WWWV                 WWVVV                aWWW
WW   W   W   W  WW                   WWVVVa                WWVV  W   W   W   W  WWWV                 WWVVV                aWWW
WW   W   W   W  WWWWWWWWWWWWWWWWWWWWWWWWWWWWWWWWWWWWWWWWWWWWWV  W   W   W   W  WWWWWWWWWWWWWWWWWWWWWWWWWWWWWWWWWWWWWWWWWWWWW
WW   W   W   W                                                 W   W   W   W                                              W
WW   W   W   W                                                 W   W   W   W                                              W
WW   W   W   W                                                 W   W   W   W                                              W
WW   W   W   W                                                 W           W                                              W
WW   W   W   W                                                 W           W                                              W
WW   W   W   W                                                 W           W                                              W
WW   W   W   W                                                 W           W                                              W
WW   W A WaaaW                                                 WWWWWWWWWWWWW                                              W
WWWWWWWWWWWWW                                                 WWWWWWWWWWWWW                                              W
WWWWWWWWWWWWW                                                 WWWWWWWWWWWWW                                              W
WWWWWWWWWWWWW                                                 WWWWWWWWWWWWW                                              W
WWWWWWWWWWWWW                                                 WWWWWWWWWWWWW                                              W
WWWWWWWWWWWWW                                                 WWWWWWWWWWWWW                                              W
WWVVVVVVVVVVW                                                 WaaaW A W   W                                              W
WV           V                                                 W   W   W   W                                              W
WV           V                                                 W   W   W   W                                              W
WV   W   W   V                                                 W   W   W   W                                              W
WV   W   W   V                                                 W   W   W   W                                              W
WV   W   W   V                                                 W   W   W   W                                              W
WV   W   W   V                                                 W   W   W   W                                              W
WV   W   W   V                                                 W   W   W   W                                              W
WV   W   W   V                                                 W   W   W   W                                              W
WV   W   W   V                                                 W   W   W   W                                              W
WV   W   W   V                                                 W   W   W   W                                              W
WV   W   W   V                                                 W   W   W   W                                              W
WV   W   W   V                                                 W   W   W   W                                              W
WV   W   W   V                                                 W   W   W   W                                              W
WV   W   W   V                                                 W   W   W   W                                              W
WV   W   W   V                                                 W   W   W   W                                              W
WVaaaW A W   V                                                 W           W                                              W
WVVVVVVVVVVVV                                                 W           W                                              W
WVVVVVVVVVVVV                                                 W           W                                              W
WVVVVVVVVVVVV                                                 WWWWWWWWWWWWW                                              W
WVVVVVVVVVVVV                                                 WWWWWWWWWWWWW                                              W
WVVVVVVVVVVVV                                                 WWWWWWWWWWWWW                                              W
WVVVVVVVVVVVV                                                 WWWWWWWWWWWWW                                              W
WVVVVVVVVVVVV                                                 WWWWWWWWWWWWW                                              W
WWWWWWWWWWWWWWWWWWWWWWWWWWWWWWWWWWWWWWWWWWWWWWWWWWWWWWWWWWWWWWWWWWWWWWWWWWWWWWWWWWWWWWWWWWWWWWWWWWWWWWWWWWWWWWWWWWWWWWWWWW
