##################################################################################################
##############..################################..#############..#################################
##############..##_..........#####..........####..#############..####........._#####...........###
##############..##_..........#####..........####..#...#.@.#___#..####........._#####...........###
##############..##_..........#####..........####..#...#...#...#..####........._#####...........###
##...........#..##########...############...####..#...#...#...#..####...############...###########
##...........#..##...........#####..........####..#...#...#...#..####..........#####...........###
##...........#..##@..........#####@.........####..#...#...#...#..####.........@#####..........@###
##...#...#...#..##...........#####..........####..#...#...#...#..####..........#####...........###
##...#...#...#..##########...############...####..#...#...#...#..####...############...###########
##...#...#...#..##...........#####_.........####..#...#...#...#..####..........#####.........._###
##...#...#...#..##...........#####_.........####..#...........#..####..........#####.........._###
##...#...#...#..##...........#####_.........####..#...........#..####..........#####.........._###
##...#...#...#..################################..#...........#..#################################
##...#.@.#___#....................................#############..................................#
##############....................................#############..................................#
##############....................................#############..................................#
##############....................................#############..................................#
##############....................................#############..................................#
##############....................................#############..................................#
##...........#....................................#...........#..................................#
##...........#....................................#...........#..................................#
##...........#....................................#...........#..................................#
##...#...#...#....................................#...#...#...#..................................#
##...#...#...#....................................#...#...#...#..................................#
##...#...#...#....................................#...#...#...#..................................#
##...#...#...#....................................#...#...#...#..................................#
##...#...#...#....................................#...#...#...#..................................#
##...#...#...#....................................#...#...#...#..................................#
##...#...#...#....................................#...#...#...#..................................#
##___#.@.#...#....................................#___#.@.#...#..................................#
##############....................................#############..................................#
##############....................................#############..................................#
##################################################################################################