##################################################################################################
##############  ################################  #############  #################################
##############  ##a          #####          ####  #############  ####         a#####           ###
##############  ##a          #####          ####  #   # A #aaa#  ####         a#####           ###
##############  ##a          #####          ####  #   #   #   #  ####         a#####           ###
##           #  ##########   ############   ####  #   #   #   #  ####   ############   ###########
##           #  ##           #####          ####  #   #   #   #  ####          #####           ###
##           #  ##A          #####A         ####  #   #   #   #  ####         A#####          A###
##   #   #   #  ##           #####          ####  #   #   #   #  ####          #####           ###
##   #   #   #  ##########   ############   ####  #   #   #   #  ####   ############   ###########
##   #   #   #  ##           #####a         ####  #   #   #   #  ####          #####          a###
##   #   #   #  ##           #####a         ####  #           #  ####          #####          a###
##   #   #   #  ##           #####a         ####  #           #  ####          #####          a###
##   #   #   #  ################################  #           #  #################################
##   # A #aaa#                                    #############                                  #
##############                                    #############                                  #
##############                                    #############                                  #
##############                                    #############                                  #
##############                                    #############                                  #
##############                                    #############                                  #
##           #                                    #           #                                  #
##           #                                    #           #                                  #
##           #                                    #           #                                  #
##   #   #   #                                    #   #   #   #                                  #
##   #   #   #                                    #   #   #   #                                  #
##   #   #   #                                    #   #   #   #                                  #
##   #   #   #                                    #   #   #   #                                  #
##   #   #   #                                    #   #   #   #                                  #
##   #   #   #                                    #   #   #   #                                  #
##   #   #   #                                    #   #   #   #                                  #
##aaa# A #   #                                    #aaa# A #   #                                  #
##############                                    #############                                  #
##############                                    #############                                  #
##################################################################################################
