#############
#############
#############
#############
#...........#
#...........#
#...........#
#...#...#...#
#...#...#...#
#...#...#...#
#...#...#...#
#...#...#...#
#...#...#...#
#...#...#...#
#...#...#...#
#...#...#...#
#...#...#...#
#...#...#...#
#...#...#...#
#...#...#...#
#...#...#...#
#...#...#...#
#...#...#...#
#...#...#...#
#...#...#...#
#...#...#...#
#...#...#...#
#...#...#...#
#...#.@.#___#
#############
#############
#############
#############
#############
#...........#
#...........#
#...........#
#...#...#...#
#...#...#...#
#...#...#...#
#...#...#...#
#...#...#...#
#...#...#...#
#...#...#...#
#...#...#...#
#...#...#...#
#...#...#...#
#...#...#...#
#...#...#...#
#...#...#...#
#...#...#...#
#...#...#...#
#...#...#...#
#...#...#...#
#...#...#...#
#...#...#...#
#...#...#...#
#...#...#...#
#___#.@.#...#
#############
#############
#############
#############
#############
#############
#___#.@.#...#
#...#...#...#
#...#...#...#
#...#...#...#
#...#...#...#
#...#...#...#
#...#...#...#
#...#...#...#
#...#...#...#
#...#...#...#
#...#...#...#
#...#...#...#
#...#...#...#
#...#...#...#
#...#...#...#
#...#...#...#
#...#...#...#
#...#...#...#
#...#...#...#
#...#...#...#
#...#...#...#
#...#...#...#
#...........#
#...........#
#...........#
#############
#############
#############
#############
#############
#...#.@.#___#
#...#...#...#
#...#...#...#
#...#...#...#
#...#...#...#
#...#...#...#
#...#...#...#
#...#...#...#
#...#...#...#
#...#...#...#
#...#...#...#
#...#...#...#
#...#...#...#
#...#...#...#
#...#...#...#
#...#...#...#
#...#...#...#
#...#...#...#
#...#...#...#
#...#...#...#
#...#...#...#
#...#...#...#
#...........#
#...........#
#...........#
#############
#############