WWWWWWWWWWWWW
WWWWWWWWWWWWW
WWWWWWWWWWWWW
WWWWWWWWWWWWW
W           W
W           W
W           W
W   W   W   W
W   W   W   W
W   W   W   W
W   W   W   W
W   W   W   W
W   W   W   W
W   W   W   W
W   W   W   W
W   W   W   W
W   W   W   W
W   W   W   W
W   W   W   W
W   W   W   W
W   W   W   W
W   W   W   W
W   W   W   W
W   W   W   W
W   W   W   W
W   W   W   W
W   W   W   W
W   W   W   W
W   W A WmnaW
WWWWWWWWWWWWW
WWWWWWWWWWWWW
WWWWWWWWWWWWW
WWWWWWWWWWWWW
WWWWWWWWWWWWW
W           W
W           W
W           W
W   W   W   W
W   W   W   W
W   W   W   W
W   W   W   W
W   W   W   W
W   W   W   W
W   W   W   W
W   W   W   W
W   W   W   W
W   W   W   W
W   W   W   W
W   W   W   W
W   W   W   W
W   W   W   W
W   W   W   W
W   W   W   W
W   W   W   W
W   W   W   W
W   W   W   W
W   W   W   W
W   W   W   W
WmnaW A W   W
WWWWWWWWWWWWW
WWWWWWWWWWWWW
WWWWWWWWWWWWW
WWWWWWWWWWWWW
WWWWWWWWWWWWW
WWWWWWWWWWWWW
WmnaW A W   W
W   W   W   W
W   W   W   W
W   W   W   W
W   W   W   W
W   W   W   W
W   W   W   W
W   W   W   W
W   W   W   W
W   W   W   W
W   W   W   W
W   W   W   W
W   W   W   W
W   W   W   W
W   W   W   W
W   W   W   W
W   W   W   W
W   W   W   W
W   W   W   W
W   W   W   W
W   W   W   W
W   W   W   W
W           W
W           W
W           W
WWWWWWWWWWWWW
WWWWWWWWWWWWW
WWWWWWWWWWWWW
WWWWWWWWWWWWW
WWWWWWWWWWWWW
W   W A WmnaW
W   W   W   W
W   W   W   W
W   W   W   W
W   W   W   W
W   W   W   W
W   W   W   W
W   W   W   W
W   W   W   W
W   W   W   W
W   W   W   W
W   W   W   W
W   W   W   W
W   W   W   W
W   W   W   W
W   W   W   W
W   W   W   W
W   W   W   W
W   W   W   W
W   W   W   W
W   W   W   W
W   W   W   W
W           W
W           W
W           W
WWWWWWWWWWWWW
WWWWWWWWWWWWW
