WWWWWWWWWWWWWWWWWWWWWWWWWWWWWWWWWWWWWWWWWWWWWWWWWWWWWWWWWWWWWWWWWWWWWWWWWWWWWWWWWWWWWWWWWWWWWWWWWW
W             W           W           W           W           W           W           W             W
W      a      W           W           W           W           W           W           W      a      W
W             W           W           W           W           W           W           W             W
WWWWWWWWWWWWWWW           W           W           W           W           W           WWWWWWWWWWWWWWW
W             W           W           W           W           W           W           W             W
W      A      W           W           W           W           W           W           W      A      W
W             W           W           W           W           W           W           W             W
WWWWWWWWWWWWWWWWWWWWWWWWWWWWWWWW      W      WWWWWWWWWWWWWWWWWWWWWWWWWWWWWWWWWWWWWWWWWWWWWWWWWWWWWW
W                                     W                                                           W
W                                     W                                                           W
W                                     W                                                           W
W                                     W                                                           W
W                                  WWWWWWW                                                        W
W                                  W     W                                                        W
W                                  W  A  W                                                        W
W                                  W     W                                                        W
W                                  WWWWWWW                                                        W
W                                     W                                                           W
W                                     W                                                           W
W                                     W                                                           W
W                                     W                                                           W
WWWWWWWWWWWWWWWWWWWWWWWWWWWWWWWW      W      WWWWWWWWWWWWWWWWWWWWWWWWWWWWWWWWWWWWWWWWWWWWWWWWWWWWWW
W             W           W           W           W           W           W           W             W
W      a      W           W           W           W           W           W           W      a      W
W             W           W           W           W           W           W           W             W
WWWWWWWWWWWWWWW           W           W           W           W           W           WWWWWWWWWWWWWWW
W             W           W           W           W           W           W           W             W
W      A      W           W           W           W           W           W           W      A      W
W             W           W           W           W           W           W           W             W
WWWWWWWWWWWWWWWWWWWWWWWWWWWWWWWWWWWWWWWWWWWWWWWWWWWWWWWWWWWWWWWWWWWWWWWWWWWWWWWWWWWWWWWWWWWWWWWWW
