################################
#               a              #
#  ##########################  #
#  #                        #  #
#  #                        #  #
#  #  ###############  ###  #  #
#  #  #             #    #  #  #
#  #  #             #    #  #  #
#  #  #  ##############  #  #  #
#  #  #  #   #        #  #  #  #
#  #  #  #  a#        # a#  #  #
#  #  #  #  ########  #  #  #  #
#  #  #  #  #A     #a #  #  #  #
#  #  #  #  #      #  #  #  #  #
#  #  #  #  ###### #  #  #  #  #
#  #  #  #  #      #  #  #  #  #
#  #  #  #  #      #  #  #  #  #
#  #  #  #  #      #  #  #     #
#  #  #  #  ###  ###  #  #     #
#  #  #  #            #  #a    #
#  #  #  #            #  ####  #
#  #  #  ##########  ##  #  #  #
#  #  #                  #  #  #
#  #  #                  #  #  #
#  #  ####################  #  #
#  #                        #  #
#  #                        #  #
#  ##########################  #
#                              #
#                              #
#                              #
################################
