WWWWWWWWWWWWWWWWWWWWWWWWWWWWWWWWWWWWWWWWWWWWWWWWWWWWWWWWWWWWWWWWWWWWWWWWWWWWWWWWWWWWWWWWWWWWWWWWWW
W                                                                                                W
W    WWWWWWWWWWWa         WWWWWWWWWWW         aWWWWWWWWWWW         WWWWWWWWWWW         aWWWWWW    W
W    W         W          W         W          W         W          W         W          W     W    W
W    W    A    W          W         W          W         W          W         W          W  a  W    W
W    W         W          W    a    W          W    A    W          W    a    W          W     W    W
W    WWWWWWWWWWWWWWWWWWWWWWWWWWWWWWWWWWWWWWWWWWWWWWWWWWWWWWWWWWWWWWWWWWWWWWWWWWWWWWWWWWWWWWWWWWW    W
W                                                                                                W
W                                                                                                W
W    WWWWWWWWWWW         aWWWWWWWWWWW         WWWWWWWWWWW         aWWWWWWWWWWW         WWWWWWW    W
W    W         W          W         W          W         W          W         W          W     W    W
W    W    a    W          W         W          W    a    W          W         W          W  A  W    W
W    W         W          W    A    W          W         W          W    A    W          W     W    W
W    WWWWWWWWWWWWWWWWWWWWWWWWWWWWWWWWWWWWWWWWWWWWWWWWWWWWWWWWWWWWWWWWWWWWWWWWWWWWWWWWWWWWWWWWWWW    W
W                                                                                                W
W                                                                                                W
W    WWWWWWWWWWWa         WWWWWWWWWWW         aWWWWWWWWWWW         WWWWWWWWWWW         aWWWWWW    W
W    W         W          W         W          W         W          W         W          W     W    W
W    W    A    W          W         W          W         W          W         W          W  a  W    W
W    W         W          W    a    W          W    A    W          W    a    W          W     W    W
W    WWWWWWWWWWWWWWWWWWWWWWWWWWWWWWWWWWWWWWWWWWWWWWWWWWWWWWWWWWWWWWWWWWWWWWWWWWWWWWWWWWWWWWWWWWWWWWw
W                                                                                                W
W                                                                                                W
W    WWWWWWWWWWW         aWWWWWWWWWWW         WWWWWWWWWWW         aWWWWWWWWWWW         WWWWWWW    W
W    W         W          W         W          W         W          W         W          W     W    W
W    W    a    W          W         W          W    a    W          W         W          W  A  W    W
W    W         W          W    A    W          W         W          W    A    W          W     W    W
W    WWWWWWWWWWWWWWWWWWWWWWWWWWWWWWWWWWWWWWWWWWWWWWWWWWWWWWWWWWWWWWWWWWWWWWWWWWWWWWWWWWWWWWWWWWW    W
W                                                                                                W
WWWWWWWWWWWWWWWWWWWWWWWWWWWWWWWWWWWWWWWWWWWWWWWWWWWWWWWWWWWWWWWWWWWWWWWWWWWWWWWWWWWWWWWWWWWWWWWWWW
