##########################################################################################################################
#############..#############################################..#############..#############################################
#############..##a................#####.................####..#############..####................a#####.................##
#############..##a................#####.................####..#...#.@.#aaa#..####................a#####.................##
#############..##a................#####.................####..#...#...#...#..####................a#####.................##
#...........#..################...###################...####..#...#...#...#..####...###################...################
#...........#..##.................#####.................####..#...#...#...#..####.................#####.................##
#...........#..##@................#####@................####..#...#...#...#..####................@#####................@##
#...#...#...#..##.................#####.................####..#...#...#...#..####.................#####.................##
#...#...#...#..################...###################...####..#...#...#...#..####...###################...################
#...#...#...#..##.................#####a................####..#...#...#...#..####.................#####................a##
#...#...#...#..##.................#####a................####..#...#...#...#..####.................#####................a##
#...#...#...#..##.................#####a................####..#...#...#...#..####.................#####................a##
#...#...#...#..#############################################..#...#...#...#..#############################################
#...#...#...#.................................................#...#...#...#..............................................#
#...#...#...#.................................................#...#...#...#..............................................#
#...#...#...#.................................................#...#...#...#..............................................#
#...#...#...#.................................................#...........#..............................................#
#...#...#...#.................................................#...........#..............................................#
#...#...#...#.................................................#...........#..............................................#
#...#...#...#.................................................#...........#..............................................#
#...#.@.#aaa#.................................................#############..............................................#
#############.................................................#############..............................................#
#############.................................................#############..............................................#
#############.................................................#############..............................................#
#############.................................................#############..............................................#
#############.................................................#############..............................................#
#...........#.................................................#aaa#.@.#...#..............................................#
#...........#.................................................#...#...#...#..............................................#
#...........#.................................................#...#...#...#..............................................#
#...#...#...#.................................................#...#...#...#..............................................#
#...#...#...#.................................................#...#...#...#..............................................#
#...#...#...#.................................................#...#...#...#..............................................#
#...#...#...#.................................................#...#...#...#..............................................#
#...#...#...#.................................................#...#...#...#..............................................#
#...#...#...#.................................................#...#...#...#..............................................#
#...#...#...#.................................................#...#...#...#..............................................#
#...#...#...#.................................................#...#...#...#..............................................#
#...#...#...#.................................................#...#...#...#..............................................#
#...#...#...#.................................................#...#...#...#..............................................#
#...#...#...#.................................................#...#...#...#..............................................#
#...#...#...#.................................................#...#...#...#..............................................#
#...#...#...#.................................................#...#...#...#..............................................#
#aaa#.@.#...#.................................................#...........#..............................................#
#############.................................................#...........#..............................................#
#############.................................................#...........#..............................................#
#############.................................................#############..............................................#
#############.................................................#############..............................................#
#############.................................................#############..............................................#
#############.................................................#############..............................................#
#############.................................................#############..............................................#
##########################################################################################################################