WWWWWWWWWWWWWWWWWWWWWWWWWWWWWWWWWWWWWWWWWWWWWWWWWWWWWWWWWWWWWWWWWWWWWWWWWWWWWWWWWWWWWWWWWWWWWWWWWWWWWWWWWWWWWWWWWWWWWWWWWW
WWWWWWWWWWWWW  WWWWWWWWWWWWWWWWWWWWWWWWWWWWWWWWWWWWWWWWWWWWW  WWWWWWWWWWWWW  WWWWWWWWWWWWWWWWWWWWWWWWWWWWWWWWWWWWWWWWWWWWW
WWWWWWWWWWWWW  WWm                WWWWW                 WWWW  WWWWWWWWWWWWW  WWWW                mWWWWW                 WW
WWWWWWWWWWWWW  WWn                WWWWW                 WWWW  W   W A WmnaW  WWWW                nWWWWW                 WW
WWWWWWWWWWWWW  WWa                WWWWW                 WWWW  W   W   W   W  WWWW                aWWWWW                 WW
W           W  WWWWWWWWWWWWWWWW   WWWWWWWWWWWWWWWWWWW   WWWW  W   W   W   W  WWWW   WWWWWWWWWWWWWWWWWWW   WWWWWWWWWWWWWWWW
W           W  WW                 WWWWW                 WWWW  W   W   W   W  WWWW                 WWWWW                 WW
W           W  WWA                WWWWWA                WWWW  W   W   W   W  WWWW                AWWWWW                AWW
W   W   W   W  WW                 WWWWW                 WWWW  W   W   W   W  WWWW                 WWWWW                 WW
W   W   W   W  WWWWWWWWWWWWWWWW   WWWWWWWWWWWWWWWWWWW   WWWW  W   W   W   W  WWWW   WWWWWWWWWWWWWWWWWWW   WWWWWWWWWWWWWWWW
W   W   W   W  WW                 WWWWWm                WWWW  W   W   W   W  WWWW                 WWWWW                mWW
W   W   W   W  WW                 WWWWWn                WWWW  W   W   W   W  WWWW                 WWWWW                nWW
W   W   W   W  WW                 WWWWWa                WWWW  W   W   W   W  WWWW                 WWWWW                aWW
W   W   W   W  WWWWWWWWWWWWWWWWWWWWWWWWWWWWWWWWWWWWWWWWWWWWW  W   W   W   W  WWWWWWWWWWWWWWWWWWWWWWWWWWWWWWWWWWWWWWWWWWWWW
W   W   W   W                                                 W   W   W   W                                              W
W   W   W   W                                                 W   W   W   W                                              W
W   W   W   W                                                 W   W   W   W                                              W
W   W   W   W                                                 W           W                                              W
W   W   W   W                                                 W           W                                              W
W   W   W   W                                                 W           W                                              W
W   W   W   W                                                 W           W                                              W
W   W A WmnaW                                                 WWWWWWWWWWWWW                                              W
WWWWWWWWWWWWW                                                 WWWWWWWWWWWWW                                              W
WWWWWWWWWWWWW                                                 WWWWWWWWWWWWW                                              W
WWWWWWWWWWWWW                                                 WWWWWWWWWWWWW                                              W
WWWWWWWWWWWWW                                                 WWWWWWWWWWWWW                                              W
WWWWWWWWWWWWW                                                 WWWWWWWWWWWWW                                              W
W           W                                                 WmnaW A W   W                                              W
W           W                                                 W   W   W   W                                              W
W           W                                                 W   W   W   W                                              W
W   W   W   W                                                 W   W   W   W                                              W
W   W   W   W                                                 W   W   W   W                                              W
W   W   W   W                                                 W   W   W   W                                              W
W   W   W   W                                                 W   W   W   W                                              W
W   W   W   W                                                 W   W   W   W                                              W
W   W   W   W                                                 W   W   W   W                                              W
W   W   W   W                                                 W   W   W   W                                              W
W   W   W   W                                                 W   W   W   W                                              W
W   W   W   W                                                 W   W   W   W                                              W
W   W   W   W                                                 W   W   W   W                                              W
W   W   W   W                                                 W   W   W   W                                              W
W   W   W   W                                                 W   W   W   W                                              W
W   W   W   W                                                 W   W   W   W                                              W
WmnaW A W   W                                                 W           W                                              W
WWWWWWWWWWWWW                                                 W           W                                              W
WWWWWWWWWWWWW                                                 W           W                                              W
WWWWWWWWWWWWW                                                 WWWWWWWWWWWWW                                              W
WWWWWWWWWWWWW                                                 WWWWWWWWWWWWW                                              W
WWWWWWWWWWWWW                                                 WWWWWWWWWWWWW                                              W
WWWWWWWWWWWWW                                                 WWWWWWWWWWWWW                                              W
WWWWWWWWWWWWW                                                 WWWWWWWWWWWWW                                              W
WWWWWWWWWWWWWWWWWWWWWWWWWWWWWWWWWWWWWWWWWWWWWWWWWWWWWWWWWWWWWWWWWWWWWWWWWWWWWWWWWWWWWWWWWWWWWWWWWWWWWWWWWWWWWWWWWWWWWWWWWW
