+----------------------------------------------------------------------------------------------------+
|####################################################################################################|
|####################################################################################################|
|####################################################################################################|
|####################################################################################################|
|####################################################################################################|
|####################################################################################################|
|############                                                                    ##      ############|
|############  ##            Si                                ##                        ############|
|############  ##      O2                              Ge          ##        ##      ##  ############|
|############    ##                  ########                                      ##    ############|
|############    ##      ##          ############                    ##      O2          ############|
|############            ##      ############  ##              ##                        ############|
|############            ##      ############  ####                          ####        ############|
|############        ######            ########                ##        ##        ##    ############|
|############                        ##                                            ##    ############|
|############  ##########                                    O2                          ############|
|############                                                          ##      ##        ############|
|############          ########  Ca        O2                                            ############|
|############Ca              ##                                              Ge          ############|
|############            Ca  ##          ######          ######                          ############|
|############                ##          ##O2              Ge##                      O2  ############|
|############          ##                ##        Ch        ##            ##            ############|
|############          ##          Ge                                      ####          ############|
|############        Ca##                          As        Si              ####        ############|
|############          ##                        @@  @@@@@@                    ##        ############|
|############          ##                                                                ############|
|############          ##                          En                                    ############|
|############                    ##      ##Ca              Si##              Ge          ############|
|############                Ge  ##      ##                  ##                          ############|
|############                    ##      ######          ######                          ############|
|############          ##        ##                                  ##                  ############|
|############          ##        ##                                    ####      O2      ############|
|############                    ##    Ca    En                  Ge      ####            ############|
|############                            ##########                        ####          ############|
|############                            ##      ##            ####          ####        ############|
|############      Ca                    ##      ##          ##  ####            ##      ############|
|############        ############        ##      ##        ####    ####        ####      ############|
|############                  ######    ##      ##        ##        ######  ####        ############|
|############                            ##      ##        ####          ######          ############|
|############    Ca                      ##                  ####                        ############|
|############                                                  ######                    ############|
|############                                      Ge              ####                O2############|
|############          Si                                                                ############|
|############                            Ca                                    Si        ############|
|####################################################################################################|
|####################################################################################################|
|####################################################################################################|
|####################################################################################################|
|####################################################################################################|
|####################################################################################################|
+----------------------------------------------------------------------------------------------------+
