+----------------------------------------------------------------------------------------------------------------------------+
|############################################################################################################################|
|############################################################################################################################|
|############################################################################################################################|
|############################################################################################################################|
|############################################################################################################################|
|############################################################################################################################|
|############        ##                                    mi                          ##                        ############|
|############              ##          ge                                  @@                                    ############|
|############                                                                @@  mi                    ####      ############|
|############    al        ##            mi                                            mi            ##    ##    ############|
|################            ##                                  @@                                              ############|
|############                la          ##                      ##                                              ############|
|############      ##                ##                                                                          ############|
|############                          @@                        mi                                              ############|
|############                            ##                      ##        ge@@            @@  la              mi############|
|############                ##                        ##                                                  ##    ############|
|##############                      ##                                        ##                        ##  ##  ############|
|############        mi  ##              mi  ####                        ar                  ##  ge              ############|
|############                                              ##              mi              ##            ####    ############|
|############    ##                                                  ##    ##                ##  mi        ##    ############|
|############      mi    ##        la        ##            te@@      ##                          ##              ############|
|############    mi                ##    @@    ####  ##  @@                  ##                        ##        ############|
|############  ##  @@  ##        mi      ge      ##                                                              ############|
|############        mi    ##      mi          ##                  fa        ##                      ##    ##    ############|
|############                              ##          ##ar                                                      ############|
|############                                                  al              ##            ##              mi  ############|
|############        ##                                ##  fa    ##  ##                      ##    ##            ############|
|############                            ##            ##                    mi    mi        ##          ##      ############|
|############          ##  mi##                                te        ##        ##la              ##          ############|
|############            ##                      ##                              mi        ##                  @@############|
|############                      @@                                      ##                                  ##############|
|############  ##                                                                                                ############|
|############              ge    ##  ##                          ##      mi    ##                                ############|
|############                                          @@                    ##  @@ar                            ############|
|############mi##                la@@  ##                                                ##            ##    ##  ############|
|############                                                                        ##            te            ############|
|############    ##                                                                                              ############|
|############                                            mi          ##                          mi              ############|
|############            la                  mi                          ##            ##    ##          ##      ############|
|############        ##        ##                    ##            mi            @@                              ############|
|############        mi    ####                ##      ##      ##                      ge    ##    mi  ##        ############|
|############              ##                                          ##  ##                                    ############|
|############    ##                                                                ##    ##  al              ##  ############|
|############    ##    ##                                mi@@        ##                              ##        ##############|
|############    te        ##          al                  ar  ##        mi      @@                        la    ############|
|############        ##          mi  mi                                    ##                    ##              ############|
|############                                      ##                                    ##            mi        ############|
|############      ##    ##    ##          ##              fa                                  ##                ############|
|############                            ##        ##                        ##      ##              ##          ############|
|############                  ##        ##        @@      @@                                            mi      ############|
|############@@    ##                                mi                ge                                    mi  ############|
|############                        ##                ##            ##                          mi              ############|
|############                              ##      mi                    ####                                    ############|
|############            ##                ge  ##      ##  ##mi  ##@@                  mi                    la  ############|
|############              ##                                    @@    fa    ##                ##          @@    ############|
|############                            ##            ##    ##          ##              ##              ##      ############|
|############################################################################################################################|
|############################################################################################################################|
|############################################################################################################################|
|############################################################################################################################|
|############################################################################################################################|
|############################################################################################################################|
+----------------------------------------------------------------------------------------------------------------------------+
