########################################
########################################
#######################.._...###########
#######################......###########
#######################......###########
####.....##############......#####..n..#
####.....##############......#####.....#
####.....##############......#####.....#
####.....#####....#####......#####.....#
####.....#####....####.......#####.....#
#......................................#
#......................................#
#@.....................................#
#......................................#
#......................................#
###...m..####.....###############......#
###......####.....###############......#
#############.....######################
#############.....######################
#############.....######################
#############.....######################
#############.....######################
#############.....######################
########################################
########################################
########################################
