########################################
#......................................#
#......#######.........................#
#.........m............................#
#......#######.........................#
#......................................#
#......................................#
#..............@.............#.#.......#
#............................#.#.......#
#............................#n#.......#
#............................#.#.......#
#............................#.#.......#
#.............#.#......................#
#.............#_#......................#
#.............#.#......................#
#......................................#
########################################
