########################################
#.#####..@...m.........................#
#.....#.....#.....#.....##...###...#...#
#.####...........................#####.#
#.....#.....#.....#.....#.....#........#
#.####.#........###.#..........#####...#
#.....#.....#.....#.....#.....#........#
#.....#.....#.....#.....#.....#........#
#.....#............#.....#.............#
#...#.....#...#.....#...#..............#
#.#.###.._...###.#.#...................#
#.#...........#.#.#.....#...........#.##
#.#####..............#........##.#####.#
#.....#.....#.....#.....#.....#.....#..#
#.####.#........###.#......n...###.....#
#.....#.....#.....#.....#.....#.....#..#
########################################
