####################
#........_.........#
#..................#
#..................#
#..................#
####............####
#..................#
#......#....#......#
#......#....#......#
#......#....#......#
#......#....#......#
#......#....#......#
#......#....#......#
#......#....#......#
#....m.#..@.#..n...#
####################
