##########################
#@..............#........#
#...............##########
#...#######..............#
#...########.............#
#...#.....m#.............#
#...#......#.............#
#...#.....##.............#
#...#...........#........#
#...#...........#........#
#...............#........#
#.............###........#
#......................#.#
#...............#......#.#
#......................#.#
#..............#n..###.#.#
#..............####......#
#........................#
#........................#
#............#############
#................._......#
#....#...................#
##########################
