############################
#..........................#
#...@......................#
#..........................#
#.............#............#
#.............#............#
#.............#............#
#.............#............#
#.......##############.....#
#.............#............#
#.............#..m.........#
#.............#............#
#.............#............#
#..........................#
#..........................#
#..........................#
#..........................#
#......############........#
#..............n...........#
#..........................#
#.............#............#
#.............#............#
#########..........#########
#..........................#
#..........................#
#..........................#
#..........................#
#.............#............#
#.............#............#
#.............#..._........#
#.............#............#
############################
