#######################################################################
#......#.............#......#.............#......#....................#
#..@.................#................n...#...........................#
#.............#....................#......#.............#.............#
#......#......#......#......#......#.............#......#.............#
#####.............#######..####.########.####.########.###.........._.#
#......#......#.............#......#.............#......#.............#
#.............#.............#......#.............#....................#
#.............#......#..m.................#......#....................#
#......#.............#......#.............#.............#.............#
#......#.............#......#......#......#.............#.............#
#######################################################################
