#################################
#................#..............#
#................#..............#
#.......#........#..............#
#.......#........#..............#
#..._...#........#.m............#
#########........########.......#
#...............................#
#...............................#
#.......@.......................#
#......................##########
#......................#.n......#
#...................... ........#
#...............................#
#...............................#
#################################
