###########
#.......#m#
#.###..#..#
#.#....#..#
#.#._..#..#
#.#..@.#..#
#.#....#..#
#.#.####..#
#n#.......#
###########