#################
#r.............R#
#......1........#
#...............#
#...............#
########S########
#.......1.......#
#.......2.......#
########S########
#...............#
#...............#
#......2........#
#R.............r#
#################
