#########
#......m#
#1......#
####n####
#......1#
#a......#
#########
