#################
#1.............m#
#...............#
#...............#
#...............#
########n########
#..............1#
#...............#
#...............#
#a..............#
#################
