
WWWWWWWWWWWWWW
W   L  W     W
W A    W m   W
W      W     W
W      W     W
W      W     W
WWWWWWWWWWWWWW
W     W      W
W  a  W  m   W
W     W      W
W     W      W
W     W      W
WWWWWWWWWWWWWW