WWWWWWWWWWWWWWWWWWWWWWW
W                     W
W      WWWWWWWW       W
W      W   L  W       W
W      W A    W       W
W      W      W       W
W      W      W       W
W      WWWWWWWW       W
W                     W
W         a           W
W                     W
WWWWWWWWWWWWWWWWWWWWWWW