#######################
#.....................#
#......########.......#
#......#...L..#.......#
#......#.@....#.......#
#......#......#.......#
#......#......#.......#
#......########.......#
#.....................#
#.........a...........#
#.....................#
#######################