##############
#...L..#.....#
#.@....#.m...#
#......#.....#
#......#.....#
#......#.....#
##############
#.....#......#
#..a..#..m...#
#.....#......#
#.....#......#
#.....#......#
##############