WWWWWWWWWWWWWWWWWWWW
W                  W
W                  W
W                  W
W        A         W
W                  W
W           bbb    W
W           bab    W
W           bbb    W
W                  W
W                  W
WWWWWWWWWWWWWWWWWWWW