#######################
#.....................#
#......ssssssss.......#
#......s......s.......#
#......s.@....s.......#
#......s......s.......#
#......s......s.......#
#......ssssssss.......#
#.....................#
#........._...........#
#.....................#
#######################