WWWWWWWWWWWWWWWWWWWW
W                  W
W                  W
W                  W
W        A         W
W                  W
W           sss    W
W           sas    W
W           sss    W
W                  W
W                  W
WWWWWWWWWWWWWWWWWWWW