WWWWWWWWWWWWWWWWWWWWWWW
W                     W
W      ssssssss       W
W      s      s       W
W      s A    s       W
W      s      s       W
W      s      s       W
W      ssssssss      W
W                     W
W         a           W
W                     W
WWWWWWWWWWWWWWWWWWWWWWW