WWWWWWWWWWWWWWWWWWWWWWW
W                     W
W      bbbbbbbb       W
W      b      b       W
W      b A    b       W
W      b      b       W
W      b      b       W
W      bbbbbbbb       W
W                     W
W         a           W
W                     W
WWWWWWWWWWWWWWWWWWWWWWW