############################
#..........................#
#...@......................#
###############............#
#..........................#
#.._.......................#
###############............#
#.............#............#
#.......##############.....#
#.............#............#
#.............#............#
#.............#............#
#.............#............#
#..........................#
#..........................#
#..........................#
#..........................#
#......############........#
#..........................#
#..........................#
#.............#............#
#.............#............#
#########..........#########
#..........................#
#..........................#
#..........................#
#......._.....#............#
#.............#............#
#.............#............#
#.............#............#
#.............#............#
############################
