###########
#......#__#
#.###..#..#
#.#....#..#
#.#....#..#
#.#..@.#..#
#.#....#..#
#.#.####..#
#_#.......#
###########
