WWWWWWWWWWWWWWWWWWWWWWW
W          W          W
W                     W
W                     W
W                     W
W      W      W       W
W      W      W       W
W      W      W       W
W      W      W       W
W      W      W       W
W      W      W       W
W      W      W       W
W      W      W       W
W      W      W       W
W      W      W       W
W      W      W       W
W      W      W       W
W      W      W       W
W      W      W       W
W      W      W       W
W      W      W       W
W      W      W       W
W      W      W       W
W      W      W       W
W      W      W       W
W      W  A   W       W
WWWWWWWWWWWWWWWWWWWWWWW