WWWWWWWWWWWWWWWWWWWWWWWWWWWWWWWWWWWWWWWWWWW
W                                         W
W                                         W
W                                         W
W                                         W
W                                         W
W                                         W
W                                         W
W                                         W
W                                         W
W                                         W
W                                         W
W                                         W
W                                         W
W                                         W
W                                         W
W                                         W
W                                         W
W                                         W
W                                         W
W                                         W
W                                         W
W                W   A  W                 W
WWWWWWWWWWWWWWWWWWWWWWWWWWWWWWWWWWWWWWWWWWW