WWWWWWWWWWWWWWW
Wj W       W pW
W  W       W  W
W1 W     W W  W
W  WWWWWW WW  W
a             a
W  WW WWWWWW  W
W  W W     W 2W
W  W       W  W
WP W       W JW
WWWWWWWWWWWWWWW