WWWW WWWW
W  W W  W
W  W W  W
W  WWW  W
W       W
W  WWW  W
W  W W  W
W  W W  W
W  W W  W
WWWWWWWWW