WWWWWWWWWWWWWWWWWWWWWWWWWWWWWW
W                            W
W                            W
W      G                     W
W                            W
W                            W
W             G      G       W
W                            W
W                            W
W                            W
W                            W
W                            W
W                            W
W     Q              Q       W
W          a   a             W
W                            W
WWWWWWWWWWWWWWWWWWWWWWWWWWWWWW