WWWWWWWWWWWWWWWWWWWWWWWWWWWWWW
W                            W
W                            W
W      g                     W
W                            W
W                            W
W             g      g       W
W                            W
W                            W
W                            W
W                            W
W                            W
W                            W
W     Q              Q       W
W          a   a             W
W                            W
WWWWWWWWWWWWWWWWWWWWWWWWWWWWWW
