WWWWWWWWWWWWWWWWWWWWWWWWWWWWWW
W                            W
W              g             W
W                            W
W                            W
W                            W
W             g      g       W
W                            W
W                            W
W                            W
W                            W
W                            W
W                            W
W     1              2       W
W          a   a             W
W                            W
WWWWWWWWWWWWWWWWWWWWWWWWWWWWWW
