WWWWWWWWWWWWWWW
W             W
Waaa          W
WWWWWWWWWW    W
W         W   W
W     Q   W   W
W   W  Q  W   W
W   W     W   W
W   W         W
WaaaW         W
WWWWWWWWWWWWWWW
WWWWWWWWWWWWWWW
WWWWWWWWWWWWWWW
WWWWWWWWWWWWWWW
WWWWWWWWWWWWWWW
WWWWWWWWWWWWWWW
W             W
Waaa          W
WWWWWWWWWW    W
W         W   W
W     Q   W   W
W   W  Q  W   W
W   W     W   W
W   W         W
WaaaW         W
WWWWWWWWWWWWWWW