WWWWWWWWWWWWWWWWWW
W       W        W
WB    Q P Q     JW
W       W        W
WWWWWWWWWWWWWWWWWW