WWWWWWWWWWWWWW
WW           W
WW           W
WW           W
WW   W   W   W
WW   W   W   W
WW   W   W   W
WW   W   W   W
WW   W   W   W
WW a W1 2WaaaW
WWWWWWWWWWWWWW
