WWWWWWWWWWWWWW
WW           W
WW           W
WW           W
WW   W   W   W
WW   W   W   W
WW   W   W   W
WW   W   W   W
WW   W   W   W
WW a WQ QWaaaW
WWWWWWWWWWWWWW