WWWWWWWWWWWWWW
WWWWWWWWWWWWWW
WWWWWWWWWWWWWW
WWWWWWWWWWWWWW
WWWWWWWWWWWWWW
WW           W
WW           W
WW           W
WW   W   W   W
WW   W   W   W
WW   W   W   W
WW   W   W   W
WW   W   W   W
WW a WA AWaaaW
WWWWWWWWWWWWWW
WWWWWWWWWWWWWW
WWWWWWWWWWWWWW
WWWWWWWWWWWWWW
WWWWWWWWWWWWWW
WW           W
WW           W
WW           W
WW   W   W   W
WW   W   W   W
WW   W   W   W
WW   W   W   W
WW   W   W   W
WW   W   W   W
WWaaaWA AW a W
WWWWWWWWWWWWWW
WWWWWWWWWWWWWW
WWWWWWWWWWWWWW