WWWWWWWWWWWW
WAW        W
W W       aW
W W        W
W W   A    W
W W        W
W W        W
W W        W
W  a       W
WWWWWWWWWWWW