WWWWWWWWWWWWWWWWWWWWWWWWWWWWW
W                           W
W   A                       W
W                    N      W
W     R                     W
W                       B   W
W                           W
W     b             r       W
W            G              W
W                           W
W                    g      W
W            g              W
W    r                      W
W              b            W
W                           W
WWWWWWWWWWWWWWWWWWWWWWWWWWWWW