WWWWWWWWWWWWWWWWWWWWWWWWWWWWWW
W                            W
W                            W
W     R               R      W
W                            W
W                            W
W                      R     W
W                            W
WWWWWWWWW WWWWW              W
W            mW         R    W
W   Q         W              W
W            gW              W
W     Q       W              W
W            aW              W
WWWWWWWWWWWWWWWWWWWWWWWWWWWWWW