WWWWWWWWWWWWWWWWWWWWWWWWWWWWWW
W                            W
W                            W
W     E               E      W
W                            W
W                            W
W                      E     W
W                            W
WWWWWWWWW WWWWW              W
W            mW         E    W
W   Q         W              W
W            gW              W
W     Q       W              W
W            aW              W
WWWWWWWWWWWWWWWWWWWWWWWWWWWWWW