WWWWWWWWWWWWWWWWWWWWWWWWWWWWWW
W                            W
W                            W
W     2               2      W
W                            W
W                            W
W                      2     W
W                            W
WWWWWWWWW WWWWW              W
W            mW         2    W
W   1         W              W
W            gW              W
W     1       W              W
W            aW              W
WWWWWWWWWWWWWWWWWWWWWWWWWWWWWW
