WWWWWWWWWWWWWWWWWWWWWWWWWWWWWW
W                            W
W                            W
W     R               R      W
W                            W
W                            W
W                      R     W
W                            W
WWWWWWWWW WWWWW              W
W            mW         R    W
W   1         W              W
W            gW              W
W     1       W              W
W            aW              W
WWWWWWWWWWWWWWWWWWWWWWWWWWWWWW
