WWWWWWWWWWWWWWWWWWWWWWWWW
Wp          a          0W
W                       W
W                       W
W                       W
W                       W
W                       W
W                       W
W                       W
W                       W
W                       W
W                       W
W          Q Q          W
W                       W
W                       W
W                       W
W                       W
W                       W
W                       W
W                       W
W                       W
W                       W
W                       W
W          P B          W
WWWWWWWWWWWWWWWWWWWWWWWWW
WWWWWWWWWWWWWWWWWWWWWWWWW
WWWWWWWWWWWWWWWWWWWWWWWWW
WWWWWWWWWWWWWWWWWWWWWWWWW
WWWWWWWWWWWWWWWWWWWWWWWWW
Wp          a          0W
W                       W
W                       W
W                       W
W                       W
W                       W
W                       W
W                       W
W                       W
W                       W
W                       W
W          E            W
W                       W
W                       W
W                       W
W                       W
W                       W
W                       W
W                       W
W                       W
W                       W
W                       W
W          P B          W
WWWWWWWWWWWWWWWWWWWWWWWWW