WWWW WWW
W  W W a
W  W W a
W2 WWW a
W  11  a
W2 WWW a
W  W W a
W  W W a
W  W W a
WWWWWWWW