WWWWWWWWWWWWWWWWWWWWWWWWWW
W      R         R       W
W     P           P      W
W                        W
WWWWWWjWpWWWaWWjWWpWWWWWWW
W                        W
W     J   E     E J      W
W                        W
WWWWWWWWWWWWWWWWWWWWWWWWWW