WWWWWWWWWWWWWWWWWWWWWWWWWW
W      R         R       W
W     B           B      W
W                        W
WWWWWWjW0WWWaWWjWW0WWWWWWW
W                        W
W     J   E     E J      W
W                        W
WWWWWWWWWWWWWWWWWWWWWWWWWW
