WWWWWWWWWWWWWWWWWWWWWWWWW
W           W           W
W           W           W
W           W           W
W           W           W
W    A      g      A    W
W           W           W
W           W a         W
W        m  W           W
W           W           W
W           W           W
WWWWWWWWWWWWWWWWWWWWWWWWW