WWWWWWWWWWWWWWW
W Q        a  W
W          a  W
WWWWWWWW   a  W
Wa     E      W
Wa            W
Wa            W
WWWWWWWWWWWWWWW