WWWWWWWWWWWWWWW
W 1        a  W
W          a  W
WWWWWWWW   a  W
Wa     1      W
Wa            W
Wa            W
WWWWWWWWWWWWWWW
