WWWWWWWWWWWWWWW
W Q        a  W
W          a  W
WWWWWWWW   a  W
Wa     Q      W
Wa            W
Wa            W
WWWWWWWWWWWWWWW