########
#......#
#.F..S.#
#......#
#m..@..#
#......#
#......#
########
