########
#......#
#.F..S.#
#......#
#m..@..#
#..T..B#
#......#
########
