WWWWWWWWWWWWWWWWWWWWWWWW
W   a                  W
W                      W
W                 c    W
W                      W
W          A           W
W     WWWWWWWWWWW      W
W          g           W
W     WWWWWWWWWWW      W
W                      W
W                      W
W                      W
W                      W
WWWWWWWWWWWWWWWWWWWWWWWW
