WWWWWWWWWWWWWWWW
W              W
W      W W     W
W      W W     W
W      W W     W
W      W W     W
W      W W     W
W     AWgW     W
Wa     W W     W
W      W W     W
W      W W     W
W      W W     W
W      W W     W
W             cW
WWWWWWWWWWWWWWWW
