WWWWWWWWWWWWWWWWWWWWW
WWWWWWWW  a  WWWWWWWW
WWWWWWWW     WWWWWWWW
WWWWWWWW     WWWWWWWW
WWWWWWWW     WWWWWWWW
WWWWWWWW     WWWWWWWW
WWWWWWWW     WWWWWWWW
WWWWWWWW     WWWWWWWW
WWWWWWWW     WWWWWWWW
WWWWWWWW     WWWWWWWW
W                   W
W         A A       W
Wa                 aW
W        A A        W
W                   W
WWWWWWWW     WWWWWWWW
WWWWWWWW     WWWWWWWW
WWWWWWWW     WWWWWWWW
WWWWWWWW     WWWWWWWW
WWWWWWWW     WWWWWWWW
WWWWWWWW     WWWWWWWW
WWWWWWWW     WWWWWWWW
WWWWWWWW  a  WWWWWWWW
WWWWWWWWWWWWWWWWWWWWW
