type: mettagrid.map_builder.ascii.AsciiMapBuilder.Config
map_data: |-
  ################################################################################
  #..............................................................................#
  #.@@@@@@.+.....................................................................#
  #..............................................................................#
  ################################################################################
  #..............................................................................#
  #..............................................................................#
  #..............................................................................#
  ################################################################################
  #..............................................................................#
  #.............................&................................................#
  #..............................................................................#
  ################################################################################
  #..............................................................................#
  #..............................................................................#
  #..............................................................................#
  ################################################################################
  #..............................................................................#
  #.............................................................=................#
  #..............................................................................#
  ################################################################################
  #..............................................................................#
  #..............................................................................#
  #..............................................................................#
  ################################################################################
  #..............................................................................#
  #..............................................................G.O.C.S.........#
  #..............................................................................#
  ################################################################################
char_to_map_name:
  "#": wall
  ".": empty
  "C": carbon_extractor
  "S": silicon_extractor
  "O": oxygen_extractor
  "G": germanium_extractor
  "+": charger
  "&": assembler
  "=": chest
  "@": agent.agent

