WWWWWWWWWWWWWWWWWW
W       a        W
W    A           W
W                W
WWWWWW     WWWWWWW
W  b W     W g   W
W    W     W     W
W    W     W     W
W    W     W     W
W    W     W     W
W    W     W     W
W                W
W                W
W                W
WWWWWW     WWWWWWW
W  R W     WB    W
W    W     W     W
W    W     W     W
W    W     W     W
W    W     W     W
W    W     W     W
W    W     W     W
W                W
W                W
W                W
WWWWWW     WWWWWWW
W  g W     W G   W
W    W     W     W
W    W     W     W
W    W     W     W
W    W     W     W
W    W     W     W
W    W     W     W
W                W
W                W
W                W
WWWWWWWWWWWWWWWWWW