WWWWWWWWWWWWWWWWWWWWWWWWWWWWW
W    W   W   W    W A aW  G W
W    W   W   W    W    W    W
W    W   W   W    W    W    W
W    W   W   W    W    W    W
W    W   W   W    W    W    W
W    W   W   W    W    W    W
W    W   W   W    W    W    W
W    W   W   W    W    W    W
W    W   W   W    W   WW    W
W                           W
W                           W
W                           W
W                           W
W                           W
W                           W
W                           W
W                           W
W                           W
W                           W
W                           W
W       g                   W
W                           W
W                           W
W                           W
W                           W
WWWWWWWWWWWWWWWWWWWWWWWWWWWWW