WWWWWWWWWWWWWWWWWWWWWWWWWWWW
W    W                WA  aW
W G  W                W    W
W    W                W    W
W    W                W    W
W    W                W    W
W    W                W    W
W                          W
W                          W
W                     W    W
W                     W    W
W                     W    W
W                     W    W
W                     W    W
W   WWWWWWWWWWW       WWWWWW
W                          W
W                          W
W      WWWWWWWWWWWW        W
W                          W
W                          W
W                          W
W                          W
WWWWWWWWW          WWWWWWWWW
W                          W
W                          W
W                          W
W       g                  W
W                          W
W                          W
W                          W
W                          W
WWWWWWWWWWWWWWWWWWWWWWWWWWWW