+--------------------------------------------------------------------------------------------------------------------------------------------------------+
|########################################################################################################################################################|
|########################################################################################################################################################|
|########################################################################################################################################################|
|################################################            ################################################            ######    al    ################|
|################################################            ################################################            ######          ################|
|################################################            ################################################            ######          ################|
|##########          ############################            ##########    ge    ############################            ######          ################|
|##########          ############################            ##########          ############################            ######          ################|
|##########          ############################            ##########          ############################            ######          ################|
|##########          ##########        ##########            ##########          ##########        ##########            ######          ################|
|##########          ##########        ########              ##########          ##########        ########              ######          ################|
|####                                                                                                                                    ################|
|####                                                                                                                                    ################|
|####@@                                                                                                                                  ################|
|####                                                                                                                                    ################|
|####                                                                                                                                    ################|
|########      mi    ########          ##############################            ########          ########################              ################|
|########            ########          ##############################            ########          ########################              ################|
|############################          ##################################################          ########################              ################|
|############################          ##################################################          ########################              ################|
|############################          ##################################################          ######################################################|
|############################          ##################################################          ######################################################|
|############################          ##################################################          ######################################################|
|############################          ##################################################          ######################################################|
|########################################################################################################################################################|
|########################################################################################################################################################|
|########################################################################################################################################################|
|########################################################################################################################################################|
+--------------------------------------------------------------------------------------------------------------------------------------------------------+
