########
#......#
#@.....#
#......#
#.....##
#......#
##...._#
########
