######
#..._#
#....#
#....#
#....#
#....#
#.@..#
######
